Path,File,contributers,top,major,minor
mozilla-releng_build-puppet,site.pp,7,0.725,4,3
mozilla-releng_build-puppet,abstract.pp,1,1.0,1,0
mozilla-releng_build-puppet,buildservices.pp,1,1.0,1,0
mozilla-releng_build-puppet,secrets.pp,7,0.44,2,5
mozilla-releng_build-puppet,init.pp,42,0.24067300658376006,6,36
mozilla-releng_build-puppet,install.pp,19,0.26548672566371684,7,12
mozilla-releng_build-puppet,config.pp,12,0.5128205128205128,4,8
mozilla-releng_build-puppet,periodic.pp,5,0.75,5,0
mozilla-releng_build-puppet,settings.pp,29,0.22911051212938005,6,23
mozilla-releng_build-puppet,stages.pp,2,0.8333333333333334,2,0
mozilla-releng_build-puppet,setup.pp,25,0.36977491961414793,5,20
mozilla-releng_build-puppet,base.pp,28,0.37209302325581395,5,23
mozilla-releng_build-puppet,dir.pp,2,0.5,2,0
mozilla-releng_build-puppet,epel.pp,2,0.6666666666666666,2,0
mozilla-releng_build-puppet,releng-public.pp,2,0.6666666666666666,2,0
mozilla-releng_build-puppet,updates.pp,2,0.6666666666666666,2,0
mozilla-releng_build-puppet,test.pp,16,0.25396825396825395,6,10
mozilla-releng_build-puppet,slaves.pp,1,1.0,1,0
mozilla-releng_build-puppet,nodes.pp,9,0.7534246575342466,3,6
mozilla-releng_build-puppet,server.pp,13,0.3333333333333333,5,8
mozilla-releng_build-puppet,slave.pp,9,0.44,5,4
mozilla-releng_build-puppet,root.pp,6,0.7222222222222222,6,0
mozilla-releng_build-puppet,builder.pp,10,0.36363636363636365,5,5
mozilla-releng_build-puppet,atboot.pp,11,0.4339622641509434,6,5
mozilla-releng_build-puppet,yumrepo.pp,3,0.7,3,0
mozilla-releng_build-puppet,build.pp,16,0.22413793103448276,6,10
mozilla-releng_build-puppet,daemon.pp,8,0.5454545454545454,4,4
mozilla-releng_build-puppet,ntp.pp,7,0.2,7,0
mozilla-releng_build-puppet,value.pp,3,0.6,3,0
mozilla-releng_build-puppet,dev-ptmx.pp,1,1.0,1,0
mozilla-releng_build-puppet,virtualenv.pp,9,0.43209876543209874,3,6
mozilla-releng_build-puppet,mozilla-tools.pp,2,0.6363636363636364,2,0
mozilla-releng_build-puppet,tools.pp,4,0.4,4,0
mozilla-releng_build-puppet,misc_python_dir.pp,3,0.375,3,0
mozilla-releng_build-puppet,misc_python_file.pp,5,0.36363636363636365,5,0
mozilla-releng_build-puppet,pip_check_py.pp,4,0.38461538461538464,4,0
mozilla-releng_build-puppet,package.pp,6,0.42105263157894735,6,0
mozilla-releng_build-puppet,prerequisites.pp,6,0.45454545454545453,6,0
mozilla-releng_build-puppet,builds.pp,2,0.75,2,0
mozilla-releng_build-puppet,hg-shared.pp,1,1.0,1,0
mozilla-releng_build-puppet,python.pp,1,1.0,1,0
mozilla-releng_build-puppet,python26.pp,4,0.7272727272727273,4,0
mozilla-releng_build-puppet,python27.pp,12,0.3469387755102041,5,7
mozilla-releng_build-puppet,version.pp,6,0.35,6,0
mozilla-releng_build-puppet,startup.pp,8,0.5217391304347826,2,6
mozilla-releng_build-puppet,nofile.pp,3,0.3333333333333333,3,0
mozilla-releng_build-puppet,environment.pp,5,0.5882352941176471,5,0
mozilla-releng_build-puppet,global.pp,9,0.6206896551724138,3,6
mozilla-releng_build-puppet,tooltool.pp,6,0.6153846153846154,6,0
mozilla-releng_build-puppet,yum_config.pp,2,0.6666666666666666,2,0
mozilla-releng_build-puppet,custom.pp,6,0.45454545454545453,6,0
mozilla-releng_build-puppet,reboot.pp,6,0.46153846153846156,6,0
mozilla-releng_build-puppet,check.pp,3,0.6,3,0
mozilla-releng_build-puppet,buildbot.pp,10,0.2916666666666667,6,4
mozilla-releng_build-puppet,child_procs_regex.pp,2,0.6666666666666666,2,0
mozilla-releng_build-puppet,ganglia.pp,4,0.5,4,0
mozilla-releng_build-puppet,http_redirect_ip.pp,2,0.6666666666666666,2,0
mozilla-releng_build-puppet,ide_smart.pp,3,0.5,3,0
mozilla-releng_build-puppet,mysql.pp,8,0.35714285714285715,8,0
mozilla-releng_build-puppet,ntp_time.pp,2,0.6666666666666666,2,0
mozilla-releng_build-puppet,procs_regex.pp,2,0.6666666666666666,2,0
mozilla-releng_build-puppet,swap.pp,2,0.6666666666666666,2,0
mozilla-releng_build-puppet,checks.pp,1,1.0,1,0
mozilla-releng_build-puppet,plugin.pp,3,0.5555555555555556,3,0
mozilla-releng_build-puppet,service.pp,13,0.45454545454545453,6,7
mozilla-releng_build-puppet,master.pp,3,0.6,3,0
mozilla-releng_build-puppet,puppetize_sh.pp,3,0.7777777777777778,3,0
mozilla-releng_build-puppet,user_pip_conf.pp,5,0.5,5,0
mozilla-releng_build-puppet,mock.pp,13,0.2564102564102564,6,7
mozilla-releng_build-puppet,git.pp,12,0.25,4,8
mozilla-releng_build-puppet,mock_mozilla.pp,4,0.5714285714285714,4,0
mozilla-releng_build-puppet,py27_mercurial.pp,17,0.1875,7,10
mozilla-releng_build-puppet,py27_virtualenv.pp,7,0.5,7,0
mozilla-releng_build-puppet,ccache_dir.pp,3,0.5,3,0
mozilla-releng_build-puppet,ccache.pp,4,0.5,4,0
mozilla-releng_build-puppet,editors.pp,6,0.4,6,0
mozilla-releng_build-puppet,common.pp,11,0.30612244897959184,7,4
mozilla-releng_build-puppet,sudo.pp,4,0.3333333333333333,4,0
mozilla-releng_build-puppet,defaults.pp,6,0.2857142857142857,6,0
mozilla-releng_build-puppet,systemsetup.pp,4,0.25,4,0
mozilla-releng_build-puppet,supervisord.pp,4,0.25,4,0
mozilla-releng_build-puppet,supervise.pp,4,0.375,4,0
mozilla-releng_build-puppet,fragment.pp,1,1.0,1,0
mozilla-releng_build-puppet,repos.pp,6,0.3333333333333333,6,0
mozilla-releng_build-puppet,net-snmp-utils.pp,3,0.3333333333333333,3,0
mozilla-releng_build-puppet,nslookup.pp,5,0.3333333333333333,5,0
mozilla-releng_build-puppet,rsync.pp,4,0.25,4,0
mozilla-releng_build-puppet,screen.pp,5,0.5,5,0
mozilla-releng_build-puppet,unzip.pp,6,0.25,6,0
mozilla-releng_build-puppet,foopy.pp,4,0.4,4,0
mozilla-releng_build-puppet,diffutils.pp,3,0.6666666666666666,3,0
mozilla-releng_build-puppet,puppet.pp,6,0.8421052631578947,2,4
mozilla-releng_build-puppet,logs.pp,5,0.3333333333333333,5,0
mozilla-releng_build-puppet,local.pp,4,0.25,4,0
mozilla-releng_build-puppet,bin.pp,5,0.42857142857142855,5,0
mozilla-releng_build-puppet,pkgdmg.pp,4,0.6666666666666666,4,0
mozilla-releng_build-puppet,screenresolution.pp,5,0.6666666666666666,5,0
mozilla-releng_build-puppet,config-moco.pp,2,0.6,2,0
mozilla-releng_build-puppet,common_known_hosts.pp,5,0.3333333333333333,5,0
mozilla-releng_build-puppet,known_host.pp,3,0.5,3,0
mozilla-releng_build-puppet,initd.pp,3,0.5,3,0
mozilla-releng_build-puppet,launchd.pp,3,0.5,3,0
mozilla-releng_build-puppet,wget.pp,8,0.375,8,0
mozilla-releng_build-puppet,account.pp,11,0.5161290322580645,4,7
mozilla-releng_build-puppet,autologin.pp,5,0.47058823529411764,5,0
mozilla-releng_build-puppet,talos.pp,5,0.42857142857142855,5,0
mozilla-releng_build-puppet,httpd.pp,10,0.5263157894736842,5,5
mozilla-releng_build-puppet,appearence.pp,1,1.0,1,0
mozilla-releng_build-puppet,appearance.pp,7,0.42857142857142855,7,0
mozilla-releng_build-puppet,mailx.pp,5,0.5,5,0
mozilla-releng_build-puppet,postfix.pp,5,0.5,5,0
mozilla-releng_build-puppet,appstate.pp,4,0.3333333333333333,4,0
mozilla-releng_build-puppet,aws.pp,7,0.47058823529411764,7,0
mozilla-releng_build-puppet,mercurial.pp,4,0.42857142857142855,4,0
mozilla-releng_build-puppet,mod_passenger.pp,3,0.5,3,0
mozilla-releng_build-puppet,mod_ssl.pp,3,0.5,3,0
mozilla-releng_build-puppet,puppetserver.pp,3,0.5714285714285714,3,0
mozilla-releng_build-puppet,standalone.pp,2,0.7,2,0
mozilla-releng_build-puppet,sync_data.pp,2,0.6666666666666666,2,0
mozilla-releng_build-puppet,update_crl.pp,2,0.6,2,0
mozilla-releng_build-puppet,puppetmaster.pp,6,0.2857142857142857,6,0
mozilla-releng_build-puppet,iptables.pp,5,0.3333333333333333,5,0
mozilla-releng_build-puppet,alsa.pp,4,0.25,4,0
mozilla-releng_build-puppet,gtk2.pp,4,0.25,4,0
mozilla-releng_build-puppet,pango.pp,4,0.25,4,0
mozilla-releng_build-puppet,telnet.pp,4,0.25,4,0
mozilla-releng_build-puppet,x_libs.pp,5,0.2,5,0
mozilla-releng_build-puppet,keys.pp,17,0.3584905660377358,5,12
mozilla-releng_build-puppet,userconfig.pp,6,0.631578947368421,6,0
mozilla-releng_build-puppet,hpasm.pp,3,0.5,3,0
mozilla-releng_build-puppet,hplog.pp,3,0.5,3,0
mozilla-releng_build-puppet,hp_health.pp,3,0.5714285714285714,3,0
mozilla-releng_build-puppet,supervisor.pp,2,0.7142857142857143,2,0
mozilla-releng_build-puppet,services.pp,13,0.21212121212121213,7,6
mozilla-releng_build-puppet,xvfb.pp,3,0.5,3,0
mozilla-releng_build-puppet,openipmi.pp,5,0.5,5,0
mozilla-releng_build-puppet,tzdata.pp,3,0.3333333333333333,3,0
mozilla-releng_build-puppet,xcode_cmdline_tools.pp,4,0.625,4,0
mozilla-releng_build-puppet,java.pp,6,0.375,6,0
mozilla-releng_build-puppet,hgtool.pp,5,0.42857142857142855,5,0
mozilla-releng_build-puppet,mobile-services.pp,1,1.0,1,0
mozilla-releng_build-puppet,rsyslog.pp,7,0.5238095238095238,3,4
mozilla-releng_build-puppet,tftpd.pp,4,0.625,4,0
mozilla-releng_build-puppet,opt.pp,5,0.45454545454545453,5,0
mozilla-releng_build-puppet,bmm.pp,4,0.5,4,0
mozilla-releng_build-puppet,tftp-server.pp,3,0.3333333333333333,3,0
mozilla-releng_build-puppet,xinetd.pp,4,0.25,4,0
mozilla-releng_build-puppet,frontend.pp,1,1.0,1,0
mozilla-releng_build-puppet,logrotate.pp,3,0.5,3,0
mozilla-releng_build-puppet,rsyslog_mysql.pp,4,0.42857142857142855,4,0
mozilla-releng_build-puppet,patch.pp,6,0.16666666666666666,6,0
mozilla-releng_build-puppet,rc_local.pp,3,0.5,3,0
mozilla-releng_build-puppet,inventorysync.pp,3,0.7142857142857143,3,0
mozilla-releng_build-puppet,mozpool.pp,2,0.6666666666666666,2,0
mozilla-releng_build-puppet,file.pp,5,0.3333333333333333,5,0
mozilla-releng_build-puppet,script.pp,2,0.6666666666666666,2,0
mozilla-releng_build-puppet,gittool.pp,4,0.25,4,0
mozilla-releng_build-puppet,retry.pp,4,0.25,4,0
mozilla-releng_build-puppet,git-shared.pp,2,0.5,2,0
mozilla-releng_build-puppet,dbcron.pp,2,0.8333333333333334,2,0
mozilla-releng_build-puppet,desktop.pp,4,0.4,4,0
mozilla-releng_build-puppet,displaymanager.pp,3,0.5,3,0
mozilla-releng_build-puppet,aptrepo.pp,4,0.5555555555555556,4,0
mozilla-releng_build-puppet,fonts.pp,5,0.4,5,0
mozilla-releng_build-puppet,ntpdate.pp,4,0.25,4,0
mozilla-releng_build-puppet,vncserver.pp,3,0.3333333333333333,3,0
mozilla-releng_build-puppet,cleanup.pp,4,0.5714285714285714,4,0
mozilla-releng_build-puppet,locale.pp,3,0.3333333333333333,3,0
mozilla-releng_build-puppet,nodejs.pp,5,0.375,5,0
mozilla-releng_build-puppet,llvm.pp,2,0.5,2,0
mozilla-releng_build-puppet,none.pp,1,1.0,1,0
mozilla-releng_build-puppet,linux_desktop.pp,2,0.5,2,0
mozilla-releng_build-puppet,tcp_keepalive.pp,2,0.6666666666666666,2,0
mozilla-releng_build-puppet,procmail.pp,4,0.25,4,0
mozilla-releng_build-puppet,ia32libs.pp,5,0.42857142857142855,5,0
mozilla-releng_build-puppet,notification_daemon.pp,2,0.5,2,0
mozilla-releng_build-puppet,motd.pp,3,0.5,3,0
mozilla-releng_build-puppet,gnome-settings-daemon.pp,1,1.0,1,0
mozilla-releng_build-puppet,buildbot_master.pp,4,0.4444444444444444,4,0
mozilla-releng_build-puppet,queue.pp,9,0.3,9,0
mozilla-releng_build-puppet,gcc.pp,3,0.3333333333333333,3,0
mozilla-releng_build-puppet,make.pp,3,0.3333333333333333,3,0
mozilla-releng_build-puppet,mysql-devel.pp,1,1.0,1,0
mozilla-releng_build-puppet,strace.pp,2,0.5,2,0
mozilla-releng_build-puppet,buildmaster.pp,6,0.2727272727272727,6,0
mozilla-releng_build-puppet,libglib20_bin.pp,2,0.5,2,0
mozilla-releng_build-puppet,nvidia_drivers.pp,7,0.3,7,0
mozilla-releng_build-puppet,gpu.pp,7,0.2,7,0
mozilla-releng_build-puppet,headless.pp,4,0.3333333333333333,4,0
mozilla-releng_build-puppet,netcat.pp,3,0.3333333333333333,3,0
mozilla-releng_build-puppet,xrestop.pp,2,0.5,2,0
mozilla-releng_build-puppet,i82574l_aspm.pp,2,0.5,2,0
mozilla-releng_build-puppet,extlookup.pp,1,1.0,1,0
mozilla-releng_build-puppet,createrepo.pp,2,0.5,2,0
mozilla-releng_build-puppet,debmirror.pp,3,0.5,3,0
mozilla-releng_build-puppet,data.pp,3,0.8333333333333334,3,0
mozilla-releng_build-puppet,deploy.pp,4,0.5,4,0
mozilla-releng_build-puppet,dirs.pp,2,0.75,2,0
mozilla-releng_build-puppet,manifests.pp,3,0.7777777777777778,3,0
mozilla-releng_build-puppet,public_mirror.pp,2,0.5,2,0
mozilla-releng_build-puppet,puppetsync_user.pp,2,0.8571428571428571,2,0
mozilla-releng_build-puppet,ssl.pp,3,0.7142857142857143,3,0
mozilla-releng_build-puppet,moco-config.pp,32,0.1536697247706422,6,26
mozilla-releng_build-puppet,moco-nodes.pp,34,0.19460500963391136,4,30
mozilla-releng_build-puppet,moco_aws_use1-config.pp,4,0.5,4,0
mozilla-releng_build-puppet,moco_aws_usw2-config.pp,4,0.5,4,0
mozilla-releng_build-puppet,seamonkey-config.pp,6,0.43478260869565216,3,3
mozilla-releng_build-puppet,relabs-config.pp,7,0.8490566037735849,2,5
mozilla-releng_build-puppet,relabs-nodes.pp,3,0.8518518518518519,2,1
mozilla-releng_build-puppet,puppet_agent.pp,2,0.5,2,0
mozilla-releng_build-puppet,servo-config.pp,8,0.48936170212765956,2,6
mozilla-releng_build-puppet,servo-nodes.pp,3,0.6153846153846154,3,0
mozilla-releng_build-puppet,cron.pp,19,0.36363636363636365,6,13
mozilla-releng_build-puppet,instance.pp,20,0.3305084745762712,6,14
mozilla-releng_build-puppet,mozilla.pp,10,0.24,6,4
mozilla-releng_build-puppet,servo.pp,4,0.5454545454545454,4,0
mozilla-releng_build-puppet,simple.pp,4,0.5714285714285714,4,0
mozilla-releng_build-puppet,bors.pp,3,0.5,3,0
mozilla-releng_build-puppet,autoconf.pp,2,0.6666666666666666,2,0
mozilla-releng_build-puppet,nrpe.pp,5,0.4,5,0
mozilla-releng_build-puppet,p7zip.pp,3,0.3333333333333333,3,0
mozilla-releng_build-puppet,upx.pp,2,0.6666666666666666,2,0
mozilla-releng_build-puppet,yasm.pp,4,0.5,4,0
mozilla-releng_build-puppet,standard.pp,7,0.2222222222222222,7,0
mozilla-releng_build-puppet,seamonkey-nodes.pp,4,0.75,4,0
mozilla-releng_build-puppet,xcode.pp,7,0.5384615384615384,7,0
mozilla-releng_build-puppet,archive.pp,1,1.0,1,0
mozilla-releng_build-puppet,exec.pp,1,1.0,1,0
mozilla-releng_build-puppet,kernel_upgrade.pp,1,1.0,1,0
mozilla-releng_build-puppet,params.pp,3,0.3333333333333333,3,0
mozilla-releng_build-puppet,status.pp,2,0.75,2,0
mozilla-releng_build-puppet,git_shared.pp,3,0.3333333333333333,3,0
mozilla-releng_build-puppet,hg_shared.pp,3,0.3333333333333333,3,0
mozilla-releng_build-puppet,gnome_settings_daemon.pp,2,0.5,2,0
mozilla-releng_build-puppet,mysql_devel.pp,4,0.4,4,0
mozilla-releng_build-puppet,net_snmp_utils.pp,3,0.3333333333333333,3,0
mozilla-releng_build-puppet,tftp_server.pp,3,0.3333333333333333,3,0
mozilla-releng_build-puppet,dev_ptmx.pp,2,0.5,2,0
mozilla-releng_build-puppet,file_line.pp,1,1.0,1,0
mozilla-releng_build-puppet,has_interface_with.pp,1,1.0,1,0
mozilla-releng_build-puppet,has_ip_address.pp,1,1.0,1,0
mozilla-releng_build-puppet,has_ip_network.pp,1,1.0,1,0
mozilla-releng_build-puppet,customfile.pp,4,0.5714285714285714,4,0
mozilla-releng_build-puppet,homeclean.pp,3,0.5,3,0
mozilla-releng_build-puppet,people.pp,2,0.5,2,0
mozilla-releng_build-puppet,person.pp,5,0.4444444444444444,5,0
mozilla-releng_build-puppet,release_runner_access.pp,2,0.5,2,0
mozilla-releng_build-puppet,extra_authorized_key.pp,3,0.5833333333333334,3,0
mozilla-releng_build-puppet,gstreamer.pp,5,0.3333333333333333,5,0
mozilla-releng_build-puppet,collectd.pp,4,0.75,4,0
mozilla-releng_build-puppet,google_api.pp,2,0.6666666666666666,2,0
mozilla-releng_build-puppet,gaia_bumper.pp,3,0.3333333333333333,3,0
mozilla-releng_build-puppet,linux.pp,2,0.5,2,0
mozilla-releng_build-puppet,archlinux.pp,2,0.5,2,0
mozilla-releng_build-puppet,debian.pp,2,0.5,2,0
mozilla-releng_build-puppet,redhat.pp,4,0.25,4,0
mozilla-releng_build-puppet,port.pp,3,0.5,3,0
mozilla-releng_build-puppet,post.pp,3,0.5714285714285714,3,0
mozilla-releng_build-puppet,pre.pp,3,0.625,3,0
mozilla-releng_build-puppet,repo.pp,4,0.4444444444444444,4,0
mozilla-releng_build-puppet,resolvconf.pp,2,0.5,2,0
mozilla-releng_build-puppet,packagemaker.pp,3,0.6666666666666666,3,0
mozilla-releng_build-puppet,gnupg.pp,2,0.75,2,0
mozilla-releng_build-puppet,javadeveloper_for_os_x.pp,4,0.25,4,0
mozilla-releng_build-puppet,jdk16.pp,4,0.3333333333333333,4,0
mozilla-releng_build-puppet,libevent.pp,2,0.6666666666666666,2,0
mozilla-releng_build-puppet,mono.pp,2,0.5,2,0
mozilla-releng_build-puppet,android_sdk16.pp,1,1.0,1,0
mozilla-releng_build-puppet,signing_test_files.pp,4,0.4,4,0
mozilla-releng_build-puppet,signmar.pp,2,0.75,2,0
mozilla-releng_build-puppet,nss_tools.pp,4,0.4,4,0
mozilla-releng_build-puppet,openssl.pp,7,0.5,4,3
mozilla-releng_build-puppet,signing.pp,10,0.34285714285714286,7,3
mozilla-releng_build-puppet,signer.pp,2,0.5,2,0
mozilla-releng_build-puppet,libpng.pp,2,0.5,2,0
mozilla-releng_build-puppet,unixsock.pp,2,0.6666666666666666,2,0
mozilla-releng_build-puppet,fingerprint.pp,1,1.0,1,0
mozilla-releng_build-puppet,android_sdk18.pp,3,0.6,3,0
mozilla-releng_build-puppet,x86.pp,3,0.6,3,0
mozilla-releng_build-puppet,hiera_eyaml.pp,2,0.6666666666666666,2,0
mozilla-releng_build-puppet,hiera.pp,2,0.8571428571428571,2,0
mozilla-releng_build-puppet,system_git.pp,2,0.5,2,0
mozilla-releng_build-puppet,disable.pp,5,0.3,5,0
mozilla-releng_build-puppet,snmp.pp,4,0.25,4,0
mozilla-releng_build-puppet,slaveapi.pp,4,0.4,4,0
mozilla-releng_build-puppet,csv.pp,2,0.5,2,0
mozilla-releng_build-puppet,df.pp,2,0.6666666666666666,2,0
mozilla-releng_build-puppet,disk.pp,3,0.3333333333333333,3,0
mozilla-releng_build-puppet,generic.pp,2,0.5,2,0
mozilla-releng_build-puppet,interface.pp,1,1.0,1,0
mozilla-releng_build-puppet,logfile.pp,1,1.0,1,0
mozilla-releng_build-puppet,vmem.pp,2,0.5,2,0
mozilla-releng_build-puppet,profiles.pp,3,0.7142857142857143,3,0
mozilla-releng_build-puppet,config_gen.pp,3,0.3333333333333333,3,0
mozilla-releng_build-puppet,qa-config.pp,7,0.6333333333333333,2,5
mozilla-releng_build-puppet,qa-nodes.pp,3,0.6666666666666666,3,0
mozilla-releng_build-puppet,crond.pp,2,0.5,2,0
mozilla-releng_build-puppet,cowbuilder.pp,2,0.5,2,0
mozilla-releng_build-puppet,pkgbuilder.pp,1,1.0,1,0
mozilla-releng_build-puppet,bridge-utils.pp,3,0.5,3,0
mozilla-releng_build-puppet,cpu-checker.pp,3,0.5,3,0
mozilla-releng_build-puppet,qemu-kvm.pp,4,0.4,4,0
mozilla-releng_build-puppet,ubuntu-vm-builder.pp,1,1.0,1,0
mozilla-releng_build-puppet,db_maintenance.pp,5,0.375,5,0
mozilla-releng_build-puppet,base_cow.pp,2,0.5,2,0
mozilla-releng_build-puppet,extsync.pp,2,0.5,2,0
mozilla-releng_build-puppet,fake.pp,1,1.0,1,0
mozilla-releng_build-puppet,extsync_crontask.pp,3,0.3333333333333333,3,0
mozilla-releng_build-puppet,extsyncs.pp,2,0.5,2,0
mozilla-releng_build-puppet,foreman_facts.pp,3,0.5,3,0
mozilla-releng_build-puppet,pyyaml.pp,4,0.5,4,0
mozilla-releng_build-puppet,slavealloc.pp,2,0.5,2,0
mozilla-releng_build-puppet,ssh_key.pp,3,0.4,3,0
mozilla-releng_build-puppet,google_api_key.pp,2,0.6666666666666666,2,0
mozilla-releng_build-puppet,ssh_keys.pp,7,0.3333333333333333,7,0
mozilla-releng_build-puppet,user_privkey.pp,3,0.3333333333333333,3,0
mozilla-releng_build-puppet,b2g_bumper.pp,3,0.3333333333333333,3,0
mozilla-releng_build-puppet,sox.pp,3,0.3333333333333333,3,0
mozilla-releng_build-puppet,casperuser.pp,2,0.5,2,0
mozilla-releng_build-puppet,fileserver.pp,3,0.3333333333333333,3,0
mozilla-releng_build-puppet,swap_on_instance_storage.pp,2,0.5,2,0
mozilla-releng_build-puppet,ethstat.pp,2,0.5,2,0
mozilla-releng_build-puppet,aggregation.pp,2,0.5,2,0
mozilla-releng_build-puppet,filters.pp,2,0.5,2,0
mozilla-releng_build-puppet,write_graphite.pp,2,0.5,2,0
mozilla-releng_build-puppet,diamond.pp,3,0.5,3,0
mozilla-releng_build-puppet,debian_keyring.pp,2,0.5,2,0
mozilla-releng_build-puppet,libxcb1.pp,5,0.5,5,0
mozilla-releng_build-puppet,mesa.pp,5,0.6111111111111112,5,0
mozilla-releng_build-puppet,gdb.pp,3,0.6,3,0
mozilla-releng_build-puppet,resolv.pp,1,1.0,1,0
mozilla-releng_build-puppet,crontask.pp,5,0.5,5,0
mozilla-releng_build-puppet,aws_manager.pp,5,0.42857142857142855,5,0
mozilla-releng_build-puppet,buildduty.pp,2,0.5,2,0
mozilla-releng_build-puppet,instance_storage.pp,4,0.25,4,0
mozilla-releng_build-puppet,tooltool_cache.pp,3,0.3333333333333333,3,0
mozilla-releng_build-puppet,ceph_config.pp,4,0.3333333333333333,4,0
mozilla-releng_build-puppet,bouncer_check.pp,1,1.0,1,0
mozilla-releng_build-puppet,buildmaster_db_maintenance.pp,2,0.5,2,0
mozilla-releng_build-puppet,releaserunner.pp,3,0.3333333333333333,3,0
mozilla-releng_build-puppet,selfserve_agent.pp,2,0.5,2,0
mozilla-releng_build-puppet,slaverebooter.pp,2,0.5,2,0
mozilla-releng_build-puppet,mozilla_api_key.pp,3,0.3333333333333333,3,0
mozilla-releng_build-puppet,check_stop_idle.pp,2,0.5,2,0
mozilla-releng_build-puppet,mozmill_ci.pp,3,0.6,3,0
mozilla-releng_build-puppet,qa.pp,5,0.4166666666666667,5,0
mozilla-releng_build-puppet,releng.pp,10,0.29545454545454547,5,5
mozilla-releng_build-puppet,tps_ci.pp,3,0.6,3,0
mozilla-releng_build-puppet,filesystem.pp,1,1.0,1,0
mozilla-releng_build-puppet,task.pp,8,0.23529411764705882,8,0
mozilla-releng_build-puppet,checkout_tools.pp,6,0.3333333333333333,6,0
mozilla-releng_build-puppet,purge_builds.pp,8,0.23076923076923078,8,0
mozilla-releng_build-puppet,update_shared_repos.pp,4,0.375,4,0
mozilla-releng_build-puppet,gui.pp,3,0.5,3,0
mozilla-releng_build-puppet,ix_ipmi.pp,1,1.0,1,0
mozilla-releng_build-puppet,rc_modules.pp,2,0.5,2,0
mozilla-releng_build-puppet,ipmitool.pp,2,0.75,2,0
mozilla-releng_build-puppet,supermicro_ipmi.pp,1,1.0,1,0
mozilla-releng_build-puppet,7z920.pp,3,0.6,3,0
mozilla-releng_build-puppet,mapi_headers.pp,2,0.6666666666666666,2,0
mozilla-releng_build-puppet,psutil.pp,2,0.8,2,0
mozilla-releng_build-puppet,windows_exceptions.pp,3,0.4,3,0
mozilla-releng_build-puppet,windows_settings.pp,3,0.5,3,0
mozilla-releng_build-puppet,fake_slavealloc.pp,1,1.0,1,0
mozilla-releng_build-puppet,compliance_example.pp,1,1.0,1,0
mozilla-releng_build-puppet,purge_example.pp,1,1.0,1,0
mozilla-releng_build-puppet,service_example.pp,1,1.0,1,0
mozilla-releng_build-puppet,registry_examples.pp,2,0.5,2,0
mozilla-releng_build-puppet,disable_ms_maintenance.pp,3,0.5,3,0
mozilla-releng_build-puppet,disableddns.pp,2,0.6666666666666666,2,0
mozilla-releng_build-puppet,disableupdates.pp,3,0.5,3,0
mozilla-releng_build-puppet,winreport.pp,4,0.4,4,0
mozilla-releng_build-puppet,hddoff.pp,4,0.4,4,0
mozilla-releng_build-puppet,highperformance.pp,4,0.4,4,0
mozilla-releng_build-puppet,mozilla_build.pp,5,0.6521739130434783,3,2
mozilla-releng_build-puppet,assert.pp,2,0.6666666666666666,2,0
mozilla-releng_build-puppet,execonce.pp,2,0.75,2,0
mozilla-releng_build-puppet,ultravnc.pp,3,0.5,3,0
mozilla-releng_build-puppet,ultravnc_ini.pp,4,0.5,4,0
mozilla-releng_build-puppet,installersource.pp,2,0.5,2,0
mozilla-releng_build-puppet,puppetagain_pub_build_mozilla_org.pp,2,0.5,2,0
mozilla-releng_build-puppet,msis.pp,2,0.5,2,0
mozilla-releng_build-puppet,pkgmsi.pp,2,0.6666666666666666,2,0
mozilla-releng_build-puppet,runner.pp,7,0.5454545454545454,3,4
mozilla-releng_build-puppet,puppetmaster_certs.pp,2,0.5,2,0
mozilla-releng_build-puppet,binscope.pp,4,0.25,4,0
mozilla-releng_build-puppet,nsclient_plus_plus.pp,3,0.3333333333333333,3,0
mozilla-releng_build-puppet,pkgexe.pp,2,0.5,2,0
mozilla-releng_build-puppet,pkgzip.pp,3,0.5,3,0
mozilla-releng_build-puppet,kts.pp,2,0.75,2,0
mozilla-releng_build-puppet,python_ldap.pp,2,0.5,2,0
mozilla-releng_build-puppet,moco_ldap.pp,3,0.3333333333333333,3,0
mozilla-releng_build-puppet,server_initialize.pp,2,0.5,2,0
mozilla-releng_build-puppet,agent.pp,2,0.5,2,0
mozilla-releng_build-puppet,mig_agent.pp,8,0.48148148148148145,5,3
mozilla-releng_build-puppet,dnsmasq.pp,2,0.5,2,0
mozilla-releng_build-puppet,python-mysqldb.pp,1,1.0,1,0
mozilla-releng_build-puppet,git_remote_hg.pp,3,0.5,3,0
mozilla-releng_build-puppet,user.pp,3,0.5,3,0
mozilla-releng_build-puppet,config_mockbuild.pp,3,0.5,3,0
mozilla-releng_build-puppet,dpkg.pp,2,0.6666666666666666,2,0
mozilla-releng_build-puppet,shipit_notifier.pp,2,0.5,2,0
mozilla-releng_build-puppet,bash.pp,5,0.4166666666666667,5,0
mozilla-releng_build-puppet,check_ami.pp,4,0.5,4,0
mozilla-releng_build-puppet,nginx.pp,3,0.3333333333333333,3,0
mozilla-releng_build-puppet,proxxy.pp,2,0.6666666666666666,2,0
mozilla-releng_build-puppet,osslsigncode.pp,4,0.25,4,0
mozilla-releng_build-puppet,google_oauth_api_key.pp,3,0.5,3,0
mozilla-releng_build-puppet,log_aggregator.pp,3,0.7272727272727273,3,0
mozilla-releng_build-puppet,client.pp,7,0.2222222222222222,7,0
mozilla-releng_build-puppet,zips.pp,2,0.5,2,0
mozilla-releng_build-puppet,audisp_cef.pp,2,0.5,2,0
mozilla-releng_build-puppet,auditd.pp,2,0.5,2,0
mozilla-releng_build-puppet,darwin_clean_buildbot.pp,2,0.75,2,0
mozilla-releng_build-puppet,exception.pp,1,1.0,1,0
mozilla-releng_build-puppet,disablejit.pp,2,0.5,2,0
mozilla-releng_build-puppet,memory_paging.pp,3,0.3333333333333333,3,0
mozilla-releng_build-puppet,nouac.pp,2,0.5,2,0
mozilla-releng_build-puppet,ntfs_options.pp,3,0.3333333333333333,3,0
mozilla-releng_build-puppet,process_priority.pp,2,0.5,2,0
mozilla-releng_build-puppet,pwrshell_options.pp,2,0.5,2,0
mozilla-releng_build-puppet,shutdown_tracker.pp,2,0.5,2,0
mozilla-releng_build-puppet,windows_activation.pp,2,0.5,2,0
mozilla-releng_build-puppet,windows_setkms.pp,3,0.3333333333333333,3,0
mozilla-releng_build-puppet,etc.pp,2,0.6666666666666666,2,0
mozilla-releng_build-puppet,enable_rdp.pp,4,0.3333333333333333,4,0
mozilla-releng_build-puppet,windows.pp,5,0.5454545454545454,5,0
mozilla-releng_build-puppet,programdata.pp,2,0.5,2,0
mozilla-releng_build-puppet,puppetagain.pp,2,0.5,2,0
mozilla-releng_build-puppet,populate_shared_repos.pp,2,0.75,2,0
mozilla-releng_build-puppet,cleanslate_task.pp,3,0.3333333333333333,3,0
mozilla-releng_build-puppet,halt.pp,4,0.25,4,0
mozilla-releng_build-puppet,post_flight.pp,2,0.75,2,0
mozilla-releng_build-puppet,restart_services.pp,3,0.7142857142857143,3,0
mozilla-releng_build-puppet,checkin.pp,4,0.4,4,0
mozilla-releng_build-puppet,mozilla_geoloc_api_keys.pp,2,0.5,2,0
mozilla-releng_build-puppet,deploystudio.pp,2,0.9166666666666666,2,0
mozilla-releng_build-puppet,php.pp,2,0.5,2,0
mozilla-releng_build-puppet,subversion.pp,3,0.3333333333333333,3,0
mozilla-releng_build-puppet,libc.pp,5,0.2727272727272727,5,0
mozilla-releng_build-puppet,vs_2013_lnk.pp,3,0.5,3,0
mozilla-releng_build-puppet,kernel.pp,3,0.6666666666666666,3,0
mozilla-releng_build-puppet,rsyslog_gnutls.pp,2,0.6666666666666666,2,0
mozilla-releng_build-puppet,pywin32.pp,3,0.5,3,0
mozilla-releng_build-puppet,crash_stats_api_token.pp,3,0.4,3,0
mozilla-releng_build-puppet,clobber.pp,5,0.3333333333333333,5,0
mozilla-releng_build-puppet,bacula_enterprise_client.pp,5,0.6,5,0
mozilla-releng_build-puppet,seamonkey.pp,3,0.3333333333333333,3,0
mozilla-releng_build-puppet,ntp_peer.pp,2,0.5,2,0
mozilla-releng_build-puppet,files.pp,2,0.8,2,0
mozilla-releng_build-puppet,exes.pp,2,0.5,2,0
mozilla-releng_build-puppet,hardlink.pp,2,0.5,2,0
mozilla-releng_build-puppet,release_upgrader.pp,2,0.6666666666666666,2,0
mozilla-releng_build-puppet,open_tcp.pp,2,0.6666666666666666,2,0
mozilla-releng_build-puppet,relengapi_token.pp,2,0.5,2,0
mozilla-releng_build-puppet,conf.pp,7,0.3125,7,0
mozilla-releng_build-puppet,buildbot_bridge.pp,2,0.5,2,0
mozilla-releng_build-puppet,adjust_sdk_token.pp,3,0.3333333333333333,3,0
mozilla-releng_build-puppet,windows_network_optimization.pp,1,1.0,1,0
mozilla-releng_build-puppet,signingworker.pp,2,0.5,2,0
mozilla-releng_build-puppet,libffi.pp,2,0.5,2,0
mozilla-releng_build-puppet,funsize_scheduler.pp,2,0.5,2,0
mozilla-releng_build-puppet,windows_network_opt_netsh.pp,3,0.6666666666666666,3,0
mozilla-releng_build-puppet,windows_network_opt_registry.pp,3,0.5,3,0
mozilla-releng_build-puppet,disable_fseventsd.pp,1,1.0,1,0
mozilla-releng_build-puppet,cpu.pp,1,1.0,1,0
mozilla-releng_build-puppet,svc.pp,2,0.5,2,0
mozilla-releng_build-puppet,nxlog.pp,3,0.3333333333333333,3,0
mozilla-releng_build-puppet,statsd.pp,3,0.3333333333333333,3,0
mozilla-releng_build-puppet,nsis3_0b1.pp,2,0.5,2,0
mozilla-releng_build-puppet,bundleclone.pp,3,0.5,3,0
mozilla-releng_build-puppet,hgrc.pp,4,0.375,4,0
mozilla-releng_build-puppet,system_hgrc.pp,4,0.5,4,0
mozilla-releng_build-puppet,config_hgrc.pp,5,0.42857142857142855,5,0
mozilla-releng_build-puppet,check_free_aws_ips.pp,2,0.5,2,0
mozilla-releng_build-puppet,ec2_config.pp,1,1.0,1,0
mozilla-releng_build-puppet,metcollect.pp,2,0.6666666666666666,2,0
mozilla-releng_build-puppet,w32time.pp,2,0.5,2,0
mozilla-releng_build-puppet,startup_tasks.pp,2,0.6666666666666666,2,0
mozilla-releng_build-puppet,freshclam.pp,2,0.5,2,0
mozilla-releng_build-puppet,clamd.pp,3,0.3333333333333333,3,0
mozilla-releng_build-puppet,av.pp,3,0.5,3,0
mozilla-releng_build-puppet,disable_bonjour.pp,2,0.5,2,0
mozilla-releng_build-puppet,release_s3_credentials.pp,5,0.2,5,0
mozilla-releng_build-puppet,nightlypromotion.pp,2,0.5,2,0
mozilla-releng_build-puppet,windows_sendchange_hack.pp,3,0.3333333333333333,3,0
mozilla-releng_build-puppet,disable_indexing.pp,2,0.5,2,0
mozilla-releng_build-puppet,disable_win_defend.pp,2,0.5,2,0
mozilla-releng_build-puppet,mozilla_maintenance_service.pp,5,0.3333333333333333,5,0
mozilla-releng_build-puppet,puppet_freshness.pp,2,0.6666666666666666,2,0
mozilla-releng_build-puppet,disable_win_driver_signing.pp,2,0.5,2,0
mozilla-releng_build-puppet,disable_desktop_interruption.pp,2,0.5,2,0
mozilla-releng_build-puppet,sync_logon_scripts.pp,2,0.5,2,0
mozilla-releng_build-puppet,buildduty-tools.pp,2,0.6666666666666666,2,0
mozilla-releng_build-puppet,buildduty_tools.pp,1,1.0,1,0
mozilla-releng_build-puppet,coreutils_5_3_0.pp,2,0.5,2,0
mozilla-releng_build-puppet,ms_vc100_debug.pp,2,0.5,2,0
mozilla-releng_build-puppet,netframework-3_5.pp,2,0.5,2,0
mozilla-releng_build-puppet,talos-data.pp,1,1.0,1,0
mozilla-releng_build-puppet,win7sdk.pp,2,0.6666666666666666,2,0
mozilla-releng_build-puppet,allthethings.pp,4,0.42857142857142855,4,0
mozilla-releng_build-puppet,reportor.pp,4,0.4,4,0
mozilla-releng_build-puppet,slave_health.pp,5,0.3333333333333333,5,0
mozilla-releng_build-puppet,cruncher.pp,2,0.5,2,0
mozilla-releng_build-puppet,syncbld.pp,2,0.5,2,0
mozilla-releng_build-puppet,dumbwin32proc.pp,2,0.5,2,0
mozilla-releng_build-puppet,python35.pp,2,0.5,2,0
mozilla-releng_build-puppet,signingscriptworker.pp,2,0.6666666666666666,2,0
mozilla-releng_build-puppet,tcp_challenge_ack_limit.pp,2,0.5,2,0
mozilla-releng_build-puppet,cacert.pp,4,0.375,4,0
mozilla-releng_build-puppet,jdk17.pp,4,0.5,4,0
mozilla-releng_build-puppet,jarsigner_init.pp,3,0.7142857142857143,3,0
mozilla-releng_build-puppet,mime_types.pp,3,0.5,3,0
mozilla-releng_build-puppet,pushapkworker.pp,1,1.0,1,0
mozilla-releng_build-puppet,balrogscriptworker.pp,1,1.0,1,0
mozilla-releng_build-puppet,beetmoverscriptworker.pp,2,0.6666666666666666,2,0
mozilla-releng_build-puppet,taskcluster_worker.pp,4,0.4375,4,0
mozilla-releng_build-puppet,worker.pp,5,0.4,5,0
mozilla-releng_build-puppet,signmar_sha384.pp,2,0.75,2,0
mozilla-releng_build-puppet,security_updates.pp,4,0.5517241379310345,4,0
mozilla-releng_build-puppet,nsis.pp,2,0.6666666666666666,2,0
mozilla-releng_build-puppet,chain_of_trust.pp,2,0.6666666666666666,2,0
mozilla-releng_build-puppet,nagios.pp,3,0.6,3,0
mozilla-releng_build-puppet,pushapkscriptworker.pp,1,1.0,1,0
mozilla-releng_build-puppet,android_sdk.pp,2,0.75,2,0
mozilla-releng_build-puppet,l10n_bumper.pp,2,0.5,2,0
mozilla-releng_build-puppet,taskcluster_host_secrets.pp,5,0.375,5,0
mozilla-releng_build-puppet,generic_worker.pp,4,0.42857142857142855,4,0
mozilla-releng_build-puppet,open_vm_tools.pp,1,1.0,1,0
mozilla-releng_build-puppet,xen_tools.pp,3,0.5,3,0
mozilla-releng_build-puppet,buildbot_bridge2.pp,2,0.5,2,0
mozilla-releng_build-puppet,cltsign_file_ages.pp,1,1.0,1,0
mozilla-releng_build-puppet,xe_guest_utilities.pp,1,1.0,1,0
mozilla-releng_build-puppet,signing_file_ages.pp,3,0.3333333333333333,3,0
mozilla-releng_build-puppet,curl.pp,2,0.5,2,0
mozilla-releng_build-puppet,robustcheckout.pp,3,0.3333333333333333,3,0
mozilla-releng_build-puppet,gentoo.pp,1,1.0,1,0
mozilla-releng_build-puppet,depsigning.pp,4,0.5,4,0
mozilla-releng_build-puppet,disabled.pp,2,0.5,2,0
mozilla-releng_build-puppet,pkgappdmg.pp,2,0.5,2,0
mozilla-releng_build-puppet,builddutytools.pp,2,0.6666666666666666,2,0
mozilla-releng_build-puppet,talos_data.pp,1,1.0,1,0
mozilla-releng_build-puppet,bridge_utils.pp,1,1.0,1,0
mozilla-releng_build-puppet,cpu_checker.pp,1,1.0,1,0
mozilla-releng_build-puppet,netframework_3_5.pp,1,1.0,1,0
mozilla-releng_build-puppet,python_mysqldb.pp,1,1.0,1,0
mozilla-releng_build-puppet,qemu_kvm.pp,1,1.0,1,0
mozilla-releng_build-puppet,apps.pp,1,1.0,1,0
mozilla-releng_build-puppet,ipchain_rule.pp,2,0.6,2,0
mozilla-releng_build-puppet,networks.pp,6,0.6333333333333333,3,3
mozilla-releng_build-puppet,pf_rule.pp,1,1.0,1,0
mozilla-releng_build-puppet,distinguished_puppetmaster.pp,2,0.875,2,0
mozilla-releng_build-puppet,puppetmasters.pp,1,1.0,1,0
mozilla-releng_build-puppet,bacula_from_mdc1_bacula_host.pp,1,1.0,1,0
mozilla-releng_build-puppet,bacula_from_scl3_bacula_host.pp,1,1.0,1,0
mozilla-releng_build-puppet,puppetmaster_from_all_releng.pp,1,1.0,1,0
mozilla-releng_build-puppet,puppetmaster_sync_from_all_puppetmasters.pp,1,1.0,1,0
mozilla-releng_build-puppet,ssh_from_anywhere.pp,1,1.0,1,0
mozilla-releng_build-puppet,rules.pp,2,0.8,2,0
mozilla-releng_build-puppet,rule.pp,2,0.6666666666666666,2,0
mozilla-releng_build-puppet,table.pp,2,0.5,2,0
mozilla-releng_build-puppet,check_pending_scriptworker_tasks.pp,3,0.5,3,0
mozilla-releng_build-puppet,duo_unix.pp,1,1.0,1,0
mozilla-releng_build-puppet,pam.pp,2,0.5,2,0
mozilla-releng_build-puppet,openssh.pp,1,1.0,1,0
mozilla-releng_build-puppet,jumphost.pp,2,0.6666666666666666,2,0
mozilla-releng_build-puppet,lego.pp,1,1.0,1,0
mozilla-releng_build-puppet,transparencyscriptworker.pp,1,1.0,1,0
mozilla-releng_build-puppet,xz.pp,1,1.0,1,0
mozilla-releng_build-puppet,ssh_from_anywhere_logging.pp,1,1.0,1,0
mozilla-releng_build-puppet,vnc_from_anywhere.pp,1,1.0,1,0
mozilla-releng_build-puppet,vnc_from_anywhere_logging.pp,1,1.0,1,0
mozilla-releng_build-puppet,mac_depsigning.pp,1,1.0,1,0
mozilla-releng_build-puppet,mac_signing.pp,1,1.0,1,0
mozilla-releng_build-puppet,osx_taskcluster_worker.pp,2,0.875,2,0
mozilla-releng_build-puppet,partner_repack.pp,1,1.0,1,0
mozilla-releng_build-puppet,dep_signing_from_anywhere.pp,1,1.0,1,0
mozilla-releng_build-puppet,nightly_signing_from_anywhere.pp,1,1.0,1,0
mozilla-releng_build-puppet,rel_signing_from_anywhere.pp,1,1.0,1,0
mozilla-releng_build-puppet,python_devel.pp,1,1.0,1,0
mozilla-releng_build-puppet,redhat_rpm_config.pp,1,1.0,1,0
mozilla-releng_build-puppet,ssh_from_rejh.pp,1,1.0,1,0
mozilla-releng_build-puppet,ssh_from_rejh_logging.pp,1,1.0,1,0
mozilla-releng_build-puppet,rejh.pp,1,1.0,1,0
mozilla-releng_build-puppet,vnc_from_rejh.pp,1,1.0,1,0
mozilla-releng_build-puppet,vnc_from_rejh_logging.pp,1,1.0,1,0
mozilla-releng_build-puppet,nrpe_from_nagios.pp,1,1.0,1,0
mozilla-releng_build-puppet,scriptworkerlogrotate.pp,2,0.8,2,0
mozilla-releng_build-puppet,dep_signing_from_linux.pp,2,0.6666666666666666,2,0
mozilla-releng_build-puppet,dep_signing_from_osx.pp,2,0.6666666666666666,2,0
mozilla-releng_build-puppet,nightly_signing_from_linux.pp,2,0.6666666666666666,2,0
mozilla-releng_build-puppet,nightly_signing_from_osx.pp,2,0.6666666666666666,2,0
mozilla-releng_build-puppet,rel_signing_from_linux.pp,2,0.6666666666666666,2,0
mozilla-releng_build-puppet,rel_signing_from_osx.pp,2,0.6666666666666666,2,0
mozilla-releng_build-puppet,syslog_from_mdc1_releng.pp,1,1.0,1,0
mozilla-releng_build-puppet,syslog_from_scl3_releng.pp,1,1.0,1,0
mozilla-releng_build-puppet,slave_api.pp,1,1.0,1,0
mozilla-releng_build-puppet,slave_api_from_releng_web_cluster.pp,1,1.0,1,0
mozilla-releng_build-puppet,taskcluster_host_secrets_from_dc_test.pp,1,1.0,1,0
mozilla-releng_build-puppet,buildbot_slave.pp,1,1.0,1,0
mozilla-releng_build-puppet,check_changes.pp,1,1.0,1,0
mozilla-releng_build-puppet,misc_python.pp,1,1.0,1,0
mozilla-releng_build-puppet,releaserunner2.pp,1,1.0,1,0
mozilla-releng_build-puppet,buildbot_master_from_various.pp,1,1.0,1,0
mozilla-releng_build-puppet,ssh_from_slaveapi.pp,1,1.0,1,0
mozilla-releng_build-puppet,deploystudio_from_mdc1_releng.pp,1,1.0,1,0
mozilla-releng_build-puppet,deploystudio_from_scl3_releng.pp,1,1.0,1,0
mozilla-releng_build-puppet,releaserunner3.pp,1,1.0,1,0
mozilla-releng_build-puppet,openssl_non_xcode.pp,1,1.0,1,0
mozilla-releng_build-puppet,integration.pp,1,1.0,1,0
mozilla-releng_build-puppet,apache.pp,1,1.0,1,0
mozilla-releng_build-puppet,cacti.pp,1,1.0,1,0
mozilla-releng_build-puppet,cassandra.pp,1,1.0,1,0
mozilla-releng_build-puppet,ceph.pp,1,1.0,1,0
mozilla-releng_build-puppet,consul.pp,1,1.0,1,0
mozilla-releng_build-puppet,directory.pp,1,1.0,1,0
mozilla-releng_build-puppet,dns_check.pp,1,1.0,1,0
mozilla-releng_build-puppet,docker_daemon.pp,1,1.0,1,0
mozilla-releng_build-puppet,elasticsearch.pp,1,1.0,1,0
mozilla-releng_build-puppet,fluentd.pp,1,1.0,1,0
mozilla-releng_build-puppet,haproxy.pp,1,1.0,1,0
mozilla-releng_build-puppet,http_check.pp,1,1.0,1,0
mozilla-releng_build-puppet,jenkins.pp,1,1.0,1,0
mozilla-releng_build-puppet,jmx.pp,1,1.0,1,0
mozilla-releng_build-puppet,kong.pp,1,1.0,1,0
mozilla-releng_build-puppet,marathon.pp,1,1.0,1,0
mozilla-releng_build-puppet,memcache.pp,1,1.0,1,0
mozilla-releng_build-puppet,mesos_master.pp,1,1.0,1,0
mozilla-releng_build-puppet,mesos_slave.pp,1,1.0,1,0
mozilla-releng_build-puppet,mongo.pp,1,1.0,1,0
mozilla-releng_build-puppet,pgbouncer.pp,1,1.0,1,0
mozilla-releng_build-puppet,php_fpm.pp,1,1.0,1,0
mozilla-releng_build-puppet,postgres.pp,1,1.0,1,0
mozilla-releng_build-puppet,postgres_custom_metric.pp,1,1.0,1,0
mozilla-releng_build-puppet,process.pp,1,1.0,1,0
mozilla-releng_build-puppet,rabbitmq.pp,1,1.0,1,0
mozilla-releng_build-puppet,redis.pp,1,1.0,1,0
mozilla-releng_build-puppet,riak.pp,1,1.0,1,0
mozilla-releng_build-puppet,solr.pp,1,1.0,1,0
mozilla-releng_build-puppet,ssh.pp,1,1.0,1,0
mozilla-releng_build-puppet,tcp_check.pp,1,1.0,1,0
mozilla-releng_build-puppet,tomcat.pp,1,1.0,1,0
mozilla-releng_build-puppet,twemproxy.pp,1,1.0,1,0
mozilla-releng_build-puppet,varnish.pp,1,1.0,1,0
mozilla-releng_build-puppet,zk.pp,1,1.0,1,0
mozilla-releng_build-puppet,agent6.pp,1,1.0,1,0
mozilla-releng_build-puppet,reports.pp,1,1.0,1,0
mozilla-releng_build-puppet,tag.pp,1,1.0,1,0
mozilla-releng_build-puppet,ubuntu.pp,1,1.0,1,0
mozilla-releng_build-puppet,install_key.pp,1,1.0,1,0
mozilla-releng_build-puppet,docker_ce.pp,1,1.0,1,0
mozilla-releng_build-puppet,shipitscriptworker.pp,1,1.0,1,0
mozilla-releng_build-puppet,roller.pp,2,0.5714285714285714,2,0
mozilla-releng_build-puppet,roller_api_from_anywhere.pp,1,1.0,1,0
mozilla-releng_build-puppet,systemd.pp,2,0.8,2,0
mozilla-releng_build-puppet,treescriptworker.pp,1,1.0,1,0
mozilla-releng_build-puppet,bouncerscriptworker.pp,1,1.0,1,0
mozilla-releng_build-puppet,bacula_from_mdc2_bacula_host.pp,1,1.0,1,0
mozilla-releng_build-puppet,deploystudio_from_mdc2_releng.pp,1,1.0,1,0
mozilla-releng_build-puppet,syslog_from_mdc2_releng.pp,1,1.0,1,0
mozilla-releng_build-puppet,squashfs_tools.pp,1,1.0,1,0
mozilla-releng_build-puppet,pushsnapscriptworker.pp,1,1.0,1,0
mozilla-releng_build-puppet,security_updates_1433165.pp,1,1.0,1,0
mozilla-releng_build-puppet,python3.pp,3,0.4,3,0
mozilla-releng_build-puppet,addonscriptworker.pp,1,1.0,1,0
mozilla-releng_build-puppet,renew_cert.pp,1,1.0,1,0
mozilla-releng_build-puppet,ssh_from_roller.pp,1,1.0,1,0
mozilla-releng_build-puppet,linux_taskcluster_worker.pp,2,0.5,2,0
mozilla-releng_build-puppet,system_pip_conf.pp,1,1.0,1,0
mozilla-releng_build-puppet,dhcp.pp,1,1.0,1,0
mozilla-releng_build-puppet,xz_devel.pp,1,1.0,1,0
mozilla-releng_build-puppet,mergeday.pp,1,1.0,1,0
mozilla-releng_build-puppet,control_bug.pp,1,1.0,1,0
mozilla-releng_build-puppet,bsdpy.pp,1,1.0,1,0
mozilla-releng_build-puppet,bsdpy_from_mdc1_releng.pp,1,1.0,1,0
mozilla-releng_build-puppet,bsdpy_from_mdc2_releng.pp,1,1.0,1,0
mozilla-releng_build-puppet,signing_server_cert_check.pp,1,1.0,1,0
mozilla-releng_build-puppet,libsodium.pp,1,1.0,1,0
mozilla-releng_build-puppet,xdelta3.pp,1,1.0,1,0
mozilla-releng_build-puppet,syslog_from_mtv2_qa.pp,1,1.0,1,0
