Path,File,contributers,top,major,minor
wikimedia_puppet,manifests/admins.pp,62,0.10580912863070539,5,57
wikimedia_puppet,manifests/apaches.pp,14,0.18867924528301888,8,6
wikimedia_puppet,manifests/backups.pp,8,0.7272727272727273,3,5
wikimedia_puppet,manifests/base.pp,28,0.27314814814814814,6,22
wikimedia_puppet,manifests/certs.pp,18,0.23076923076923078,6,12
wikimedia_puppet,manifests/decommissioning.pp,26,0.21505376344086022,5,21
wikimedia_puppet,manifests/dns.pp,14,0.37037037037037035,4,10
wikimedia_puppet,manifests/drac.pp,1,1.0,1,0
wikimedia_puppet,manifests/exim.pp,4,0.4166666666666667,4,0
wikimedia_puppet,manifests/facilities.pp,11,0.2,6,5
wikimedia_puppet,manifests/ganglia.pp,45,0.14696485623003194,6,39
wikimedia_puppet,manifests/generic-definitions.pp,21,0.3333333333333333,5,16
wikimedia_puppet,manifests/gerrit.pp,26,0.32857142857142857,4,22
wikimedia_puppet,manifests/imagescaler.pp,18,0.2682926829268293,4,14
wikimedia_puppet,manifests/iptables.pp,11,0.29411764705882354,6,5
wikimedia_puppet,manifests/jobrunner.pp,5,0.4444444444444444,5,0
wikimedia_puppet,manifests/ldap.pp,12,0.7741935483870968,2,10
wikimedia_puppet,manifests/lvs.pp,22,0.6550522648083623,1,21
wikimedia_puppet,manifests/media-storage.pp,4,0.5,4,0
wikimedia_puppet,manifests/mediawiki.pp,16,0.1794871794871795,10,6
wikimedia_puppet,manifests/memcached.pp,11,0.25,6,5
wikimedia_puppet,manifests/misc-servers.pp,28,0.1543859649122807,8,20
wikimedia_puppet,manifests/mobile.pp,11,0.27586206896551724,6,5
wikimedia_puppet,manifests/mysql.pp,21,0.44541484716157204,3,18
wikimedia_puppet,manifests/nagios.pp,24,0.39800995024875624,5,19
wikimedia_puppet,manifests/network.pp,25,0.17117117117117117,7,18
wikimedia_puppet,manifests/nfs.pp,18,0.18518518518518517,8,10
wikimedia_puppet,manifests/nrpe.pp,14,0.2903225806451613,5,9
wikimedia_puppet,manifests/ntp.pp,2,0.5,2,0
wikimedia_puppet,manifests/openstack.pp,23,0.5351681957186545,3,20
wikimedia_puppet,manifests/owa.pp,3,0.5,3,0
wikimedia_puppet,manifests/passwords.pp,9,0.15384615384615385,9,0
wikimedia_puppet,manifests/ppa.pp,1,1.0,1,0
wikimedia_puppet,manifests/protoproxy.pp,11,0.3023255813953488,6,5
wikimedia_puppet,manifests/puppetmaster.pp,16,0.38011695906432746,6,10
wikimedia_puppet,manifests/search.pp,22,0.375,5,17
wikimedia_puppet,manifests/site.pp,119,0.10664551383747577,2,117
wikimedia_puppet,manifests/snapshots.pp,5,0.6363636363636364,5,0
wikimedia_puppet,manifests/squid.pp,9,0.375,5,4
wikimedia_puppet,manifests/ssh.pp,8,0.42105263157894735,8,0
wikimedia_puppet,manifests/stages.pp,6,0.3,6,0
wikimedia_puppet,manifests/sudo.pp,9,0.5483870967741935,4,5
wikimedia_puppet,manifests/svn.pp,13,0.21739130434782608,6,7
wikimedia_puppet,manifests/udpprofile.pp,1,1.0,1,0
wikimedia_puppet,manifests/varnish.pp,13,0.6870748299319728,2,11
wikimedia_puppet,manifests/mailman.pp,7,0.6,7,0
wikimedia_puppet,manifests/realm.pp,29,0.10077519379844961,7,22
wikimedia_puppet,manifests/test.pp,1,1.0,1,0
wikimedia_puppet,manifests/swift.pp,17,0.22916666666666666,5,12
wikimedia_puppet,manifests/mail.pp,24,0.28662420382165604,5,19
wikimedia_puppet,manifests/misc/bastion.pp,6,0.25,6,0
wikimedia_puppet,manifests/thumbs.pp,3,0.3333333333333333,3,0
wikimedia_puppet,manifests/misc/contint.pp,17,0.6666666666666666,1,16
wikimedia_puppet,manifests/misc/bugzilla.pp,9,0.21052631578947367,9,0
wikimedia_puppet,manifests/misc/blogs.pp,19,0.18604651162790697,5,14
wikimedia_puppet,manifests/misc/wikimanias.pp,1,1.0,1,0
wikimedia_puppet,manifests/misc/outreach.pp,8,0.4375,8,0
wikimedia_puppet,manifests/misc/wikimania.pp,2,0.5,2,0
wikimedia_puppet,manifests/misc/secure.pp,5,0.2,5,0
wikimedia_puppet,manifests/misc/planet.pp,11,0.37209302325581395,3,8
wikimedia_puppet,manifests/misc/maintenance.pp,32,0.10434782608695652,8,24
wikimedia_puppet,manifests/misc/wikistats.pp,5,0.4594594594594595,4,1
wikimedia_puppet,manifests/misc/logging.pp,19,0.19753086419753085,6,13
wikimedia_puppet,manifests/misc/mariadb.pp,1,1.0,1,0
wikimedia_puppet,manifests/role/db.pp,14,0.425531914893617,4,10
wikimedia_puppet,manifests/misc/fundraising.pp,13,0.8163265306122449,1,12
wikimedia_puppet,manifests/bots-cb.pp,1,1.0,1,0
wikimedia_puppet,manifests/misc/firewall.pp,3,0.8636363636363636,2,1
wikimedia_puppet,manifests/role/cache.pp,48,0.37628865979381443,2,46
wikimedia_puppet,manifests/misc/ipmi_mgmt.pp,1,1.0,1,0
wikimedia_puppet,manifests/webserver.pp,17,0.2037037037037037,8,9
wikimedia_puppet,manifests/misc/management.pp,3,0.3333333333333333,3,0
wikimedia_puppet,manifests/role/swift.pp,20,0.2867647058823529,4,16
wikimedia_puppet,manifests/misc/torrus.pp,7,0.8125,1,6
wikimedia_puppet,manifests/misc/statistics.pp,32,0.3447204968944099,3,29
wikimedia_puppet,manifests/role/seach.pp,1,1.0,1,0
wikimedia_puppet,manifests/misc/analytics.pp,3,0.8235294117647058,3,0
wikimedia_puppet,manifests/misc/install-server.pp,11,0.2727272727272727,5,6
wikimedia_puppet,manifests/misc/icinga.pp,34,0.31153846153846154,4,30
wikimedia_puppet,manifests/misc/package-builder.pp,7,0.41379310344827586,4,3
wikimedia_puppet,manifests/misc/mwlib.pp,4,0.8333333333333334,4,0
wikimedia_puppet,manifests/role/search.pp,1,1.0,1,0
wikimedia_puppet,manifests/role/lucene.pp,20,0.16279069767441862,6,14
wikimedia_puppet,manifests/misc/deployment-host.pp,1,1.0,1,0
wikimedia_puppet,manifests/timedmediahandler.pp,3,0.3333333333333333,3,0
wikimedia_puppet,manifests/role/statistics.pp,24,0.2926829268292683,4,20
wikimedia_puppet,manifests/misc/geoip.pp,3,0.3333333333333333,3,0
wikimedia_puppet,manifests/misc/pdf.pp,3,0.5,3,0
wikimedia_puppet,manifests/role/pdf.pp,7,0.3333333333333333,7,0
wikimedia_puppet,manifests/role/analytics.pp,14,0.4789915966386555,5,9
wikimedia_puppet,manifests/misc/java.pp,1,1.0,1,0
wikimedia_puppet,manifests/labs.pp,1,1.0,1,0
wikimedia_puppet,manifests/geoip.pp,3,0.6,3,0
wikimedia_puppet,manifests/role/labsmysql.pp,8,0.4666666666666667,8,0
wikimedia_puppet,manifests/role/labsmw.pp,2,0.9090909090909091,2,0
wikimedia_puppet,manifests/role/ipv6relay.pp,5,0.3333333333333333,5,0
wikimedia_puppet,manifests/role/labsmediawiki.pp,9,0.5,3,6
wikimedia_puppet,manifests/misc/miredo.pp,2,0.75,2,0
wikimedia_puppet,manifests/misc/wikibugs.pp,7,0.35714285714285715,7,0
wikimedia_puppet,manifests/role/dns.pp,10,0.2,8,2
wikimedia_puppet,manifests/misc/udp2log.pp,17,0.2698412698412698,6,11
wikimedia_puppet,manifests/misc/labsdebrepo.pp,5,0.5555555555555556,5,0
wikimedia_puppet,manifests/role/apache.pp,5,0.5,5,0
wikimedia_puppet,manifests/role/logging.pp,28,0.35365853658536583,3,25
wikimedia_puppet,manifests/role/wikistats.pp,3,0.5,3,0
wikimedia_puppet,modules/ntp/manifests/init.pp,1,1.0,1,0
wikimedia_puppet,modules/ntp/manifests/client.pp,3,0.3333333333333333,3,0
wikimedia_puppet,modules/ntp/manifests/server.pp,2,0.5,2,0
wikimedia_puppet,manifests/misc/smokeping.pp,4,0.5,4,0
wikimedia_puppet,manifests/misc/wlm.pp,1,1.0,1,0
wikimedia_puppet,manifests/role/planet.pp,9,0.3076923076923077,4,5
wikimedia_puppet,manifests/misc/parsoid.pp,5,0.6666666666666666,4,1
wikimedia_puppet,manifests/role/applicationserver.pp,23,0.30526315789473685,5,18
wikimedia_puppet,modules/applicationserver/manifests/config/apache.pp,7,0.26666666666666666,7,0
wikimedia_puppet,modules/applicationserver/manifests/config/php.pp,7,0.2727272727272727,7,0
wikimedia_puppet,modules/applicationserver/manifests/cron.pp,5,0.3333333333333333,5,0
wikimedia_puppet,modules/applicationserver/manifests/init.pp,6,0.2727272727272727,6,0
wikimedia_puppet,modules/applicationserver/manifests/nice.pp,1,1.0,1,0
wikimedia_puppet,modules/applicationserver/manifests/packages.pp,9,0.16666666666666666,9,0
wikimedia_puppet,modules/applicationserver/manifests/pybal_check.pp,6,0.2857142857142857,6,0
wikimedia_puppet,modules/applicationserver/manifests/sync.pp,2,0.6666666666666666,2,0
wikimedia_puppet,modules/applicationserver/manifests/syslog.pp,3,0.3333333333333333,3,0
wikimedia_puppet,modules/coredb/manifests/conf.pp,1,1.0,1,0
wikimedia_puppet,modules/coredb/manifests/datadirs.pp,1,1.0,1,0
wikimedia_puppet,modules/coredb/manifests/heartbeat.pp,1,1.0,1,0
wikimedia_puppet,modules/coredb/manifests/init.pp,1,1.0,1,0
wikimedia_puppet,modules/coredb/manifests/packages.pp,1,1.0,1,0
wikimedia_puppet,modules/coredb/manifests/snapshot.pp,1,1.0,1,0
wikimedia_puppet,modules/coredb/manifests/users.pp,1,1.0,1,0
wikimedia_puppet,modules/mediawiki/manifests/init.pp,13,0.3157894736842105,6,7
wikimedia_puppet,modules/mediawiki/manifests/users.pp,13,0.1875,7,6
wikimedia_puppet,modules/mediawiki/manifests/sync.pp,14,0.37037037037037035,5,9
wikimedia_puppet,modules/solr/manifests/init.pp,5,0.4,5,0
wikimedia_puppet,manifests/misc/rancid.pp,3,0.6666666666666666,3,0
wikimedia_puppet,modules/applicationserver/manifests/config/init.pp,1,1.0,1,0
wikimedia_puppet,modules/applicationserver/manifests/service.pp,6,0.38461538461538464,6,0
wikimedia_puppet,manifests/role/jobrunner.pp,1,1.0,1,0
wikimedia_puppet,manifests/videoscaler.pp,1,1.0,1,0
wikimedia_puppet,manifests/poolcounter.pp,3,0.3333333333333333,3,0
wikimedia_puppet,manifests/role/poolcounter.pp,8,0.2222222222222222,8,0
wikimedia_puppet,modules/applicationserver/manifests/sudo.pp,3,0.4,3,0
wikimedia_puppet,modules/mediawiki_new/manifests/init.pp,3,0.6,3,0
wikimedia_puppet,modules/mediawiki_new/manifests/sync.pp,1,1.0,1,0
wikimedia_puppet,modules/mediawiki_new/manifests/users.pp,2,0.75,2,0
wikimedia_puppet,modules/stdlib/manifests/init.pp,2,0.5,2,0
wikimedia_puppet,modules/stdlib/manifests/stages.pp,2,0.5,2,0
wikimedia_puppet,modules/stdlib/tests/file_line.pp,1,1.0,1,0
wikimedia_puppet,modules/stdlib/tests/init.pp,1,1.0,1,0
wikimedia_puppet,modules/applicationserver/manifests/config/base.pp,2,0.5,2,0
wikimedia_puppet,manifests/role/glance.pp,6,0.391304347826087,3,3
wikimedia_puppet,manifests/role/keystone.pp,7,0.40540540540540543,4,3
wikimedia_puppet,manifests/role/ldap.pp,5,0.5384615384615384,5,0
wikimedia_puppet,manifests/role/nova.pp,27,0.38271604938271603,3,24
wikimedia_puppet,manifests/role/puppet.pp,12,0.20930232558139536,5,7
wikimedia_puppet,manifests/misc/deployment.pp,29,0.14814814814814814,6,23
wikimedia_puppet,manifests/role/gerrit.pp,23,0.36363636363636365,4,19
wikimedia_puppet,modules/rsync/manifests/get.pp,3,0.3333333333333333,3,0
wikimedia_puppet,modules/rsync/manifests/init.pp,1,1.0,1,0
wikimedia_puppet,modules/rsync/manifests/repo.pp,1,1.0,1,0
wikimedia_puppet,modules/rsync/manifests/server.pp,9,0.26666666666666666,9,0
wikimedia_puppet,modules/rsync/manifests/server/module.pp,6,0.16666666666666666,6,0
wikimedia_puppet,modules/rsync/spec/fixtures/manifests/site.pp,2,0.5,2,0
wikimedia_puppet,modules/rsync/tests/init.pp,1,1.0,1,0
wikimedia_puppet,modules/rsync/tests/repo.pp,1,1.0,1,0
wikimedia_puppet,modules/rsync/tests/server_with_motd.pp,1,1.0,1,0
wikimedia_puppet,modules/salt/manifests/master.pp,12,0.3157894736842105,12,0
wikimedia_puppet,modules/salt/manifests/minion.pp,12,0.2692307692307692,4,8
wikimedia_puppet,manifests/role/salt.pp,15,0.5,4,11
wikimedia_puppet,modules/mongodb/manifests/init.pp,4,0.4,4,0
wikimedia_puppet,modules/mongodb/manifests/params.pp,1,1.0,1,0
wikimedia_puppet,modules/mongodb/manifests/sources/apt.pp,1,1.0,1,0
wikimedia_puppet,modules/mongodb/manifests/sources/yum.pp,1,1.0,1,0
wikimedia_puppet,modules/mongodb/spec/fixtures/manifests/site.pp,3,0.3333333333333333,3,0
wikimedia_puppet,modules/mongodb/tests/init.pp,1,1.0,1,0
wikimedia_puppet,modules/mongodb/tests/sources/apt.pp,1,1.0,1,0
wikimedia_puppet,modules/mongodb/tests/sources/yum.pp,1,1.0,1,0
wikimedia_puppet,manifests/misc/beta.pp,8,0.6551724137931034,4,4
wikimedia_puppet,manifests/analytics.pp,1,1.0,1,0
wikimedia_puppet,manifests/role/memcached.pp,13,0.2641509433962264,7,6
wikimedia_puppet,modules/mediawiki_new/manifests/jobrunner.pp,3,0.6,3,0
wikimedia_puppet,manifests/role/fundraising.pp,8,0.8301886792452831,1,7
wikimedia_puppet,modules/zuul/manifests/init.pp,11,0.5416666666666666,5,6
wikimedia_puppet,manifests/role/zuul.pp,11,0.5714285714285714,4,7
wikimedia_puppet,manifests/zuul.pp,7,0.7,3,4
wikimedia_puppet,modules/redis/manifests/init.pp,16,0.26,7,9
wikimedia_puppet,manifests/role/beta.pp,18,0.1875,8,10
wikimedia_puppet,modules/apt/manifests/conf.pp,3,0.4,3,0
wikimedia_puppet,modules/apt/manifests/init.pp,18,0.32608695652173914,3,15
wikimedia_puppet,modules/apt/manifests/pin.pp,4,0.3333333333333333,4,0
wikimedia_puppet,modules/apt/manifests/repository.pp,10,0.21428571428571427,10,0
wikimedia_puppet,modules/apt/manifests/unattended-upgrades.pp,1,1.0,1,0
wikimedia_puppet,modules/apt/manifests/update.pp,4,0.4,4,0
wikimedia_puppet,modules/redis/manifests/ganglia.pp,6,0.25,6,0
wikimedia_puppet,manifests/role/coredb.pp,16,0.42105263157894735,4,12
wikimedia_puppet,modules/coredb/manifests/base.pp,1,1.0,1,0
wikimedia_puppet,modules/coredb/manifests/slow_digest.pp,1,1.0,1,0
wikimedia_puppet,modules/coredb/manifests/utils.pp,1,1.0,1,0
wikimedia_puppet,modules/apt/manifests/unattendedupgrades.pp,5,0.4666666666666667,5,0
wikimedia_puppet,manifests/misc/racktables.pp,5,0.4444444444444444,5,0
wikimedia_puppet,manifests/misc/rt-server.pp,4,0.4,4,0
wikimedia_puppet,manifests/misc/download.pp,8,0.5769230769230769,4,4
wikimedia_puppet,manifests/misc/irc.pp,5,0.3333333333333333,5,0
wikimedia_puppet,manifests/misc/etherpad.pp,8,0.36666666666666664,6,2
wikimedia_puppet,manifests/misc/graphite.pp,8,0.5517241379310345,4,4
wikimedia_puppet,manifests/wikidata.pp,4,0.7777777777777778,4,0
wikimedia_puppet,modules/java/manifests/openjdk.pp,1,1.0,1,0
wikimedia_puppet,manifests/role/mirror.pp,6,0.4166666666666667,6,0
wikimedia_puppet,modules/deployment/manifests/deployment_server.pp,14,0.5384615384615384,5,9
wikimedia_puppet,modules/deployment/manifests/salt_master.pp,7,0.7073170731707317,2,5
wikimedia_puppet,modules/salt/manifests/master_environment.pp,3,0.7777777777777778,3,0
wikimedia_puppet,manifests/role/deployment.pp,33,0.3222748815165877,5,28
wikimedia_puppet,modules/java/manifests/init.pp,1,1.0,1,0
wikimedia_puppet,manifests/misc/noc.pp,10,0.375,10,0
wikimedia_puppet,manifests/misc/limesurvey.pp,1,1.0,1,0
wikimedia_puppet,modules/deployment/manifests/deployment_repo_sync_hook_link.pp,1,1.0,1,0
wikimedia_puppet,manifests/misc/images.pp,1,1.0,1,0
wikimedia_puppet,modules/apt/manifests/noupgrade.pp,2,0.5,2,0
wikimedia_puppet,modules/apache/manifests/dev.pp,1,1.0,1,0
wikimedia_puppet,modules/apache/manifests/init.pp,7,0.48484848484848486,4,3
wikimedia_puppet,modules/apache/manifests/mod.pp,12,0.25,6,6
wikimedia_puppet,modules/apache/manifests/mod/auth_basic.pp,1,1.0,1,0
wikimedia_puppet,modules/apache/manifests/mod/auth_kerb.pp,1,1.0,1,0
wikimedia_puppet,modules/apache/manifests/mod/cache.pp,1,1.0,1,0
wikimedia_puppet,modules/apache/manifests/mod/cgi.pp,1,1.0,1,0
wikimedia_puppet,modules/apache/manifests/mod/dav.pp,1,1.0,1,0
wikimedia_puppet,modules/apache/manifests/mod/dav_fs.pp,1,1.0,1,0
wikimedia_puppet,modules/apache/manifests/mod/default.pp,1,1.0,1,0
wikimedia_puppet,modules/apache/manifests/mod/dev.pp,1,1.0,1,0
wikimedia_puppet,modules/apache/manifests/mod/disk_cache.pp,1,1.0,1,0
wikimedia_puppet,modules/apache/manifests/mod/fcgid.pp,1,1.0,1,0
wikimedia_puppet,modules/apache/manifests/mod/passenger.pp,1,1.0,1,0
wikimedia_puppet,modules/apache/manifests/mod/perl.pp,1,1.0,1,0
wikimedia_puppet,modules/apache/manifests/mod/php.pp,1,1.0,1,0
wikimedia_puppet,modules/apache/manifests/mod/proxy.pp,1,1.0,1,0
wikimedia_puppet,modules/apache/manifests/mod/proxy_html.pp,1,1.0,1,0
wikimedia_puppet,modules/apache/manifests/mod/proxy_http.pp,1,1.0,1,0
wikimedia_puppet,modules/apache/manifests/mod/python.pp,1,1.0,1,0
wikimedia_puppet,modules/apache/manifests/mod/ssl.pp,1,1.0,1,0
wikimedia_puppet,modules/apache/manifests/mod/userdir.pp,1,1.0,1,0
wikimedia_puppet,modules/apache/manifests/mod/wsgi.pp,1,1.0,1,0
wikimedia_puppet,modules/apache/manifests/params.pp,4,0.25,4,0
wikimedia_puppet,modules/apache/manifests/php.pp,1,1.0,1,0
wikimedia_puppet,modules/apache/manifests/proxy.pp,1,1.0,1,0
wikimedia_puppet,modules/apache/manifests/python.pp,1,1.0,1,0
wikimedia_puppet,modules/apache/manifests/ssl.pp,1,1.0,1,0
wikimedia_puppet,modules/apache/manifests/vhost.pp,4,0.5,4,0
wikimedia_puppet,modules/apache/manifests/vhost/proxy.pp,3,0.3333333333333333,3,0
wikimedia_puppet,modules/apache/manifests/vhost/redirect.pp,3,0.3333333333333333,3,0
wikimedia_puppet,modules/apache/tests/apache.pp,1,1.0,1,0
wikimedia_puppet,modules/apache/tests/dev.pp,1,1.0,1,0
wikimedia_puppet,modules/apache/tests/init.pp,1,1.0,1,0
wikimedia_puppet,modules/apache/tests/php.pp,1,1.0,1,0
wikimedia_puppet,modules/apache/tests/vhost.pp,1,1.0,1,0
wikimedia_puppet,modules/coredb_mysql/manifests/base.pp,4,0.5,4,0
wikimedia_puppet,modules/coredb_mysql/manifests/conf.pp,2,0.75,2,0
wikimedia_puppet,modules/coredb_mysql/manifests/heartbeat.pp,2,0.5,2,0
wikimedia_puppet,modules/coredb_mysql/manifests/init.pp,3,0.75,3,0
wikimedia_puppet,modules/coredb_mysql/manifests/packages.pp,7,0.5333333333333333,7,0
wikimedia_puppet,modules/coredb_mysql/manifests/slow_digest.pp,5,0.3333333333333333,5,0
wikimedia_puppet,modules/coredb_mysql/manifests/snapshot.pp,2,0.5,2,0
wikimedia_puppet,modules/coredb_mysql/manifests/utils.pp,2,0.6,2,0
wikimedia_puppet,manifests/misc/docs.pp,5,0.2857142857142857,5,0
wikimedia_puppet,manifests/bots.pp,4,0.2857142857142857,4,0
wikimedia_puppet,manifests/role/logbot.pp,3,0.4,3,0
wikimedia_puppet,manifests/role/solr.pp,10,0.34782608695652173,3,7
wikimedia_puppet,modules/deployment/manifests/deployment_repo_dependencies_link.pp,1,1.0,1,0
wikimedia_puppet,manifests/misc/url-downloader.pp,2,0.6666666666666666,2,0
wikimedia_puppet,manifests/role/mha.pp,5,0.6666666666666666,5,0
wikimedia_puppet,modules/applicationserver/manifests/apache_packages.pp,3,0.3333333333333333,3,0
wikimedia_puppet,manifests/misc/nagios.pp,1,1.0,1,0
wikimedia_puppet,manifests/role/protoproxy.pp,15,0.32075471698113206,7,8
wikimedia_puppet,modules/testswarm/manifests/systemuser.pp,1,1.0,1,0
wikimedia_puppet,modules/contint/manifests/packages.pp,25,0.275,7,18
wikimedia_puppet,modules/haproxy/manifests/init.pp,9,0.2,9,0
wikimedia_puppet,modules/salt_reactors/manifests/init.pp,1,1.0,1,0
wikimedia_puppet,modules/mediawiki_new/manifests/cgroup.pp,3,0.3333333333333333,3,0
wikimedia_puppet,modules/mediawiki_new/manifests/users/l10nupdate.pp,1,1.0,1,0
wikimedia_puppet,modules/mediawiki_new/manifests/users/mwdeploy.pp,1,1.0,1,0
wikimedia_puppet,modules/mediawiki_new/manifests/users/sudo.pp,1,1.0,1,0
wikimedia_puppet,modules/mediawiki_new/manifests/packages.pp,1,1.0,1,0
wikimedia_puppet,manifests/misc/udpprofile.pp,5,0.2,5,0
wikimedia_puppet,modules/gridengine/manifests/exec_host.pp,7,0.3684210526315789,7,0
wikimedia_puppet,modules/gridengine/manifests/init.pp,7,0.2222222222222222,7,0
wikimedia_puppet,modules/gridengine/manifests/master.pp,10,0.46875,5,5
wikimedia_puppet,modules/gridengine/manifests/shadow_master.pp,9,0.3333333333333333,9,0
wikimedia_puppet,modules/gridengine/manifests/submit_host.pp,7,0.3888888888888889,7,0
wikimedia_puppet,modules/mediawiki_singlenode/manifests/init.pp,12,0.4,6,6
wikimedia_puppet,modules/mediawiki_singlenode/manifests/mw-extension.pp,5,0.2,5,0
wikimedia_puppet,modules/wikidata_singlenode/manifests/init.pp,5,0.375,5,0
wikimedia_puppet,modules/mediawiki/manifests/cgroup.pp,7,0.21428571428571427,7,0
wikimedia_puppet,modules/mediawiki/manifests/jobrunner.pp,16,0.32894736842105265,7,9
wikimedia_puppet,modules/mediawiki/manifests/packages.pp,17,0.2222222222222222,6,11
wikimedia_puppet,modules/mediawiki/manifests/users/l10nupdate.pp,6,0.3333333333333333,6,0
wikimedia_puppet,modules/mediawiki/manifests/users/mwdeploy.pp,3,0.3333333333333333,3,0
wikimedia_puppet,modules/mediawiki/manifests/users/sudo.pp,3,0.3333333333333333,3,0
wikimedia_puppet,manifests/misc/monitoring.pp,16,0.45794392523364486,4,12
wikimedia_puppet,modules/mysql/manifests/backup.pp,1,1.0,1,0
wikimedia_puppet,modules/mysql/manifests/config.pp,5,0.3333333333333333,5,0
wikimedia_puppet,modules/mysql/manifests/db.pp,2,0.5,2,0
wikimedia_puppet,modules/mysql/manifests/init.pp,2,0.5,2,0
wikimedia_puppet,modules/mysql/manifests/java.pp,2,0.5,2,0
wikimedia_puppet,modules/mysql/manifests/params.pp,7,0.2727272727272727,7,0
wikimedia_puppet,modules/mysql/manifests/php.pp,2,0.5,2,0
wikimedia_puppet,modules/mysql/manifests/python.pp,2,0.5,2,0
wikimedia_puppet,modules/mysql/manifests/ruby.pp,2,0.5,2,0
wikimedia_puppet,modules/mysql/manifests/server.pp,8,0.2857142857142857,8,0
wikimedia_puppet,modules/mysql/manifests/server/account_security.pp,1,1.0,1,0
wikimedia_puppet,modules/mysql/manifests/server/config.pp,2,0.6666666666666666,2,0
wikimedia_puppet,modules/mysql/manifests/server/monitor.pp,1,1.0,1,0
wikimedia_puppet,modules/mysql/manifests/server/mysqltuner.pp,2,0.5,2,0
wikimedia_puppet,modules/mysql/tests/backup.pp,2,0.5,2,0
wikimedia_puppet,modules/mysql/tests/init.pp,2,0.5,2,0
wikimedia_puppet,modules/mysql/tests/java.pp,2,0.5,2,0
wikimedia_puppet,modules/mysql/tests/mysql_database.pp,2,0.5,2,0
wikimedia_puppet,modules/mysql/tests/mysql_grant.pp,1,1.0,1,0
wikimedia_puppet,modules/mysql/tests/mysql_user.pp,2,0.5,2,0
wikimedia_puppet,modules/mysql/tests/python.pp,2,0.5,2,0
wikimedia_puppet,modules/mysql/tests/ruby.pp,2,0.5,2,0
wikimedia_puppet,modules/mysql/tests/server.pp,2,0.5,2,0
wikimedia_puppet,modules/mysql/tests/server/account_security.pp,2,0.5,2,0
wikimedia_puppet,modules/mysql/tests/server/config.pp,2,0.5,2,0
wikimedia_puppet,modules/jenkins/manifests/group.pp,2,0.6666666666666666,2,0
wikimedia_puppet,modules/jenkins/manifests/init.pp,14,0.46938775510204084,2,12
wikimedia_puppet,modules/jenkins/manifests/user.pp,5,0.5,5,0
wikimedia_puppet,modules/contint/manifests/website.pp,10,0.4166666666666667,4,6
wikimedia_puppet,modules/ganglia/manifests/configuration.pp,4,0.5,4,0
wikimedia_puppet,modules/ganglia/manifests/monitor/aggregator/init.pp,1,1.0,1,0
wikimedia_puppet,modules/ganglia/manifests/monitor/aggregator/instance.pp,6,0.3888888888888889,6,0
wikimedia_puppet,modules/ganglia/manifests/monitor/config.pp,3,0.3333333333333333,3,0
wikimedia_puppet,modules/ganglia/manifests/monitor/init.pp,1,1.0,1,0
wikimedia_puppet,modules/ganglia/manifests/monitor/packages.pp,3,0.6,3,0
wikimedia_puppet,modules/ganglia/manifests/monitor/service.pp,3,0.5,3,0
wikimedia_puppet,modules/ganglia-new/manifests/configuration.pp,1,1.0,1,0
wikimedia_puppet,modules/ganglia-new/manifests/monitor/aggregator/init.pp,1,1.0,1,0
wikimedia_puppet,modules/ganglia-new/manifests/monitor/aggregator/instance.pp,1,1.0,1,0
wikimedia_puppet,modules/ganglia-new/manifests/monitor/config.pp,1,1.0,1,0
wikimedia_puppet,modules/ganglia-new/manifests/monitor/init.pp,1,1.0,1,0
wikimedia_puppet,modules/ganglia-new/manifests/monitor/packages.pp,1,1.0,1,0
wikimedia_puppet,modules/ganglia-new/manifests/monitor/service.pp,1,1.0,1,0
wikimedia_puppet,modules/ganglia-new/manifests/init.pp,1,1.0,1,0
wikimedia_puppet,modules/ganglia-new/manifests/monitor.pp,1,1.0,1,0
wikimedia_puppet,modules/ganglia-new/manifests/monitor/aggregator.pp,1,1.0,1,0
wikimedia_puppet,modules/ganglia_new/manifests/configuration.pp,13,0.3,7,6
wikimedia_puppet,modules/ganglia_new/manifests/init.pp,1,1.0,1,0
wikimedia_puppet,modules/ganglia_new/manifests/monitor.pp,6,0.4444444444444444,6,0
wikimedia_puppet,modules/ganglia_new/manifests/monitor/aggregator.pp,6,0.36363636363636365,6,0
wikimedia_puppet,modules/ganglia_new/manifests/monitor/aggregator/instance.pp,9,0.5,3,6
wikimedia_puppet,modules/ganglia_new/manifests/monitor/config.pp,2,0.875,2,0
wikimedia_puppet,modules/ganglia_new/manifests/monitor/packages.pp,2,0.75,2,0
wikimedia_puppet,modules/ganglia_new/manifests/monitor/service.pp,5,0.3333333333333333,5,0
wikimedia_puppet,modules/contint/manifests/tmpfs.pp,2,0.8,2,0
wikimedia_puppet,modules/contint/manifests/proxy_common.pp,4,0.25,4,0
wikimedia_puppet,modules/contint/manifests/proxy_jenkins.pp,2,0.6,2,0
wikimedia_puppet,modules/contint/manifests/proxy_zuul.pp,2,0.6666666666666666,2,0
wikimedia_puppet,modules/contint/manifests/testswarm.pp,3,0.3333333333333333,3,0
wikimedia_puppet,manifests/role/redisdb.pp,13,0.20588235294117646,6,7
wikimedia_puppet,manifests/misc/haproxy.pp,2,0.5,2,0
wikimedia_puppet,modules/limn/manifests/init.pp,4,0.3333333333333333,4,0
wikimedia_puppet,modules/limn/manifests/instance.pp,6,0.375,6,0
wikimedia_puppet,modules/limn/manifests/instance/proxy.pp,3,0.7142857142857143,3,0
wikimedia_puppet,manifests/role/labsredis.pp,1,1.0,1,0
wikimedia_puppet,manifests/misc/limn.pp,3,0.6666666666666666,3,0
wikimedia_puppet,modules/eventlogging/manifests/archive.pp,2,0.6666666666666666,2,0
wikimedia_puppet,modules/eventlogging/manifests/ganglia.pp,1,1.0,1,0
wikimedia_puppet,modules/eventlogging/manifests/init.pp,13,0.3333333333333333,6,7
wikimedia_puppet,modules/mysql_multi_instance/manifests/config.pp,2,0.5,2,0
wikimedia_puppet,modules/mysql_multi_instance/manifests/init.pp,8,0.2222222222222222,8,0
wikimedia_puppet,modules/mysql_multi_instance/manifests/instance.pp,8,0.3333333333333333,6,2
wikimedia_puppet,modules/mysql_multi_instance/manifests/params.pp,1,1.0,1,0
wikimedia_puppet,modules/cpufrequtils/manifests/init.pp,5,0.42857142857142855,5,0
wikimedia_puppet,modules/eventlogging/manifests/supervisor.pp,2,0.75,2,0
wikimedia_puppet,manifests/role/request-tracker.pp,3,0.7142857142857143,3,0
wikimedia_puppet,modules/planet/manifests/apache_site.pp,1,1.0,1,0
wikimedia_puppet,modules/planet/manifests/config.pp,4,0.46153846153846156,4,0
wikimedia_puppet,modules/planet/manifests/cronjob.pp,4,0.4166666666666667,4,0
wikimedia_puppet,modules/planet/manifests/dirs.pp,4,0.5,4,0
wikimedia_puppet,modules/planet/manifests/docroot.pp,3,0.3333333333333333,3,0
wikimedia_puppet,modules/planet/manifests/index_site.pp,5,0.4,5,0
wikimedia_puppet,modules/planet/manifests/init.pp,6,0.3181818181818182,4,2
wikimedia_puppet,modules/planet/manifests/languages.pp,1,1.0,1,0
wikimedia_puppet,modules/planet/manifests/locales.pp,1,1.0,1,0
wikimedia_puppet,modules/planet/manifests/packages.pp,4,0.3333333333333333,4,0
wikimedia_puppet,modules/planet/manifests/theme.pp,5,0.42857142857142855,5,0
wikimedia_puppet,modules/planet/manifests/user.pp,3,0.6,3,0
wikimedia_puppet,modules/planet/manifests/venus.pp,1,1.0,1,0
wikimedia_puppet,modules/planet/manifests/webserver.pp,6,0.3,6,0
wikimedia_puppet,manifests/role/jenkins.pp,3,0.6666666666666666,3,0
wikimedia_puppet,modules/eventlogging/manifests/notebook.pp,1,1.0,1,0
wikimedia_puppet,manifests/role/labslamp.pp,5,0.3333333333333333,5,0
wikimedia_puppet,modules/eventlogging/manifests/mediawiki_errors.pp,2,0.6666666666666666,2,0
wikimedia_puppet,manifests/misc/gitblit.pp,5,0.5294117647058824,5,0
wikimedia_puppet,manifests/role/gitblit.pp,16,0.14814814814814814,8,8
wikimedia_puppet,manifests/role/ceph.pp,3,0.7777777777777778,3,0
wikimedia_puppet,modules/ceph/manifests/bootstrap_key.pp,2,0.6666666666666666,2,0
wikimedia_puppet,modules/ceph/manifests/init.pp,1,1.0,1,0
wikimedia_puppet,modules/ceph/manifests/mds.pp,1,1.0,1,0
wikimedia_puppet,modules/ceph/manifests/mon.pp,2,0.6666666666666666,2,0
wikimedia_puppet,modules/ceph/manifests/osd.pp,1,1.0,1,0
wikimedia_puppet,modules/ceph/manifests/radosgw.pp,3,0.75,3,0
wikimedia_puppet,modules/tcpircbot/manifests/init.pp,9,0.18181818181818182,9,0
wikimedia_puppet,modules/tcpircbot/manifests/instance.pp,7,0.3888888888888889,7,0
wikimedia_puppet,modules/eventlogging/manifests/analysis.pp,2,0.6666666666666666,2,0
wikimedia_puppet,modules/ipython/manifests/init.pp,5,0.25,5,0
wikimedia_puppet,modules/ipython/manifests/notebook.pp,3,0.5,3,0
wikimedia_puppet,modules/ipython/manifests/profile.pp,3,0.3333333333333333,3,0
wikimedia_puppet,manifests/role/labsnfs.pp,12,0.24,7,5
wikimedia_puppet,manifests/role/racktables.pp,14,0.25806451612903225,6,8
wikimedia_puppet,manifests/role/labs.pp,20,0.19540229885057472,6,14
wikimedia_puppet,modules/toollabs/manifests/bastion.pp,17,0.18309859154929578,8,9
wikimedia_puppet,modules/toollabs/manifests/dev_environ.pp,21,0.23157894736842105,4,17
wikimedia_puppet,modules/toollabs/manifests/exec_environ.pp,33,0.17672413793103448,6,27
wikimedia_puppet,modules/toollabs/manifests/execnode.pp,6,0.4666666666666667,6,0
wikimedia_puppet,modules/toollabs/manifests/init.pp,19,0.2727272727272727,5,14
wikimedia_puppet,modules/toollabs/manifests/master.pp,10,0.375,5,5
wikimedia_puppet,modules/toollabs/manifests/shadow.pp,6,0.3333333333333333,6,0
wikimedia_puppet,modules/toollabs/manifests/webproxy.pp,2,0.8,2,0
wikimedia_puppet,modules/toollabs/manifests/webserver.pp,4,0.6923076923076923,4,0
wikimedia_puppet,modules/toollabs/manifests/infrastructure.pp,8,0.5263157894736842,8,0
wikimedia_puppet,modules/toollabs/manifests/mailrelay.pp,14,0.17142857142857143,8,6
wikimedia_puppet,manifests/misc/rt-server-apache.pp,6,0.36363636363636365,6,0
wikimedia_puppet,manifests/misc/dsh.pp,4,0.5,4,0
wikimedia_puppet,modules/protoproxy/manifests/ganglia.pp,6,0.2857142857142857,6,0
wikimedia_puppet,modules/protoproxy/manifests/init.pp,7,0.14285714285714285,7,0
wikimedia_puppet,modules/protoproxy/manifests/package.pp,1,1.0,1,0
wikimedia_puppet,modules/protoproxy/manifests/service.pp,1,1.0,1,0
wikimedia_puppet,modules/jenkins/manifests/slave.pp,8,0.3076923076923077,8,0
wikimedia_puppet,modules/salt/manifests/reactors.pp,2,0.5,2,0
wikimedia_puppet,modules/mediawiki/manifests/twemproxy.pp,3,0.7,3,0
wikimedia_puppet,modules/identd/manifests/init.pp,2,0.5,2,0
wikimedia_puppet,manifests/role/smokeping.pp,6,0.5555555555555556,6,0
wikimedia_puppet,modules/toollabs/manifests/memcachesasl.pp,1,1.0,1,0
wikimedia_puppet,manifests/role/analytics/hadoop.pp,16,0.4014084507042254,2,14
wikimedia_puppet,manifests/role/analytics/zookeeper.pp,2,0.5789473684210527,2,0
wikimedia_puppet,modules/toollabs/manifests/syslog.pp,2,0.5,2,0
wikimedia_puppet,manifests/role/labsproxy.pp,11,0.2413793103448276,6,5
wikimedia_puppet,modules/nginx/manifests/init.pp,5,0.2,5,0
wikimedia_puppet,manifests/role/hadoop.pp,1,1.0,1,0
wikimedia_puppet,modules/varnish/htcppurger.pp,1,1.0,1,0
wikimedia_puppet,modules/varnish/manifests/common.pp,12,0.4186046511627907,3,9
wikimedia_puppet,modules/varnish/manifests/common/vcl.pp,11,0.25,6,5
wikimedia_puppet,modules/varnish/manifests/extra_vcl.pp,2,0.5,2,0
wikimedia_puppet,modules/varnish/manifests/init.pp,1,1.0,1,0
wikimedia_puppet,modules/varnish/manifests/instance.pp,15,0.27184466019417475,5,10
wikimedia_puppet,modules/varnish/manifests/logging.pp,12,0.38461538461538464,5,7
wikimedia_puppet,modules/varnish/manifests/logging/config.pp,2,0.5,2,0
wikimedia_puppet,modules/varnish/manifests/logging/monitor.pp,2,0.5,2,0
wikimedia_puppet,modules/varnish/manifests/monitoring/ganglia.pp,7,0.25,7,0
wikimedia_puppet,modules/varnish/manifests/packages.pp,5,0.6153846153846154,5,0
wikimedia_puppet,modules/varnish/manifests/setup_filesystem.pp,8,0.25,8,0
wikimedia_puppet,htcppurger.pp,1,1.0,1,0
wikimedia_puppet,manifests/common.pp,4,0.4,4,0
wikimedia_puppet,manifests/common/vcl.pp,4,0.25,4,0
wikimedia_puppet,manifests/extra_vcl.pp,2,0.5,2,0
wikimedia_puppet,manifests/init.pp,6,0.5333333333333333,6,0
wikimedia_puppet,manifests/instance.pp,4,0.5,4,0
wikimedia_puppet,manifests/logging.pp,4,0.25,4,0
wikimedia_puppet,manifests/logging/config.pp,2,0.5,2,0
wikimedia_puppet,manifests/logging/monitor.pp,2,0.5,2,0
wikimedia_puppet,manifests/monitoring/ganglia.pp,4,0.4,4,0
wikimedia_puppet,manifests/packages.pp,3,0.3333333333333333,3,0
wikimedia_puppet,manifests/setup_filesystem.pp,3,0.3333333333333333,3,0
wikimedia_puppet,modules/varnish/manifests/htcppurger.pp,8,0.3684210526315789,8,0
wikimedia_puppet,manifests/htcppurger.pp,4,0.4,4,0
wikimedia_puppet,modules/exim/manifests/init.pp,1,1.0,1,0
wikimedia_puppet,modules/exim/manifests/mailman.pp,1,1.0,1,0
wikimedia_puppet,modules/exim/manifests/role/mediawiki.pp,1,1.0,1,0
wikimedia_puppet,modules/exim/manifests/role/rt.pp,1,1.0,1,0
wikimedia_puppet,modules/exim/manifests/role/simple-mail-sender.pp,1,1.0,1,0
wikimedia_puppet,modules/exim/manifests/spamassassin.pp,1,1.0,1,0
wikimedia_puppet,manifests/role/analytics/hive.pp,6,0.625,2,4
wikimedia_puppet,manifests/role/analytics/pig.pp,1,1.0,1,0
wikimedia_puppet,manifests/role/analytics/sqoop.pp,1,1.0,1,0
wikimedia_puppet,modules/ldap/manifests/client.pp,15,0.20833333333333334,6,9
wikimedia_puppet,modules/ldap/manifests/role/client.pp,8,0.26666666666666666,8,0
wikimedia_puppet,modules/ldap/manifests/role/config.pp,9,0.25,9,0
wikimedia_puppet,modules/ldap/manifests/role/server.pp,9,0.26666666666666666,7,2
wikimedia_puppet,modules/ldap/manifests/server.pp,9,0.2777777777777778,9,0
wikimedia_puppet,manifests/role/labsbeta.pp,6,0.25,6,0
wikimedia_puppet,modules/ceph/manifests/key.pp,2,0.75,2,0
wikimedia_puppet,modules/toollabs/manifests/redis.pp,13,0.43243243243243246,5,8
wikimedia_puppet,manifests/misc/ishmael.pp,4,0.4,4,0
wikimedia_puppet,modules/salt/manifests/grain.pp,5,0.4,5,0
wikimedia_puppet,modules/deployment/manifests/target.pp,5,0.42857142857142855,5,0
wikimedia_puppet,modules/geoip/manifests/data.pp,1,1.0,1,0
wikimedia_puppet,modules/geoip/manifests/data/maxmind.pp,6,0.4444444444444444,6,0
wikimedia_puppet,modules/geoip/manifests/data/package.pp,2,0.5,2,0
wikimedia_puppet,modules/geoip/manifests/data/puppet.pp,4,0.5714285714285714,4,0
wikimedia_puppet,modules/geoip/manifests/init.pp,3,0.3333333333333333,3,0
wikimedia_puppet,modules/pybal/manifests/configuration.pp,5,0.5,5,0
wikimedia_puppet,modules/pybal/manifests/init.pp,5,0.375,5,0
wikimedia_puppet,modules/toollabs/manifests/tyrant.pp,2,0.75,2,0
wikimedia_puppet,manifests/role/bugzilla.pp,6,0.26666666666666666,6,0
wikimedia_puppet,manifests/role/eventlogging.pp,15,0.4057971014492754,3,12
wikimedia_puppet,modules/eventlogging/manifests/decommission.pp,1,1.0,1,0
wikimedia_puppet,modules/eventlogging/manifests/deployment.pp,3,0.6,3,0
wikimedia_puppet,modules/eventlogging/manifests/monitor.pp,2,0.6666666666666666,2,0
wikimedia_puppet,modules/eventlogging/manifests/package.pp,5,0.5,5,0
wikimedia_puppet,modules/eventlogging/manifests/service/consumer.pp,6,0.3076923076923077,6,0
wikimedia_puppet,modules/eventlogging/manifests/service/forwarder.pp,5,0.3,5,0
wikimedia_puppet,modules/eventlogging/manifests/service/multiplexer.pp,6,0.2857142857142857,6,0
wikimedia_puppet,modules/eventlogging/manifests/service/processor.pp,6,0.35714285714285715,6,0
wikimedia_puppet,manifests/role/analytics/oozie.pp,4,0.7692307692307693,4,0
wikimedia_puppet,modules/sysctlfile/manifests/high-http-performance.pp,1,1.0,1,0
wikimedia_puppet,modules/sysctlfile/manifests/init.pp,2,0.5,2,0
wikimedia_puppet,manifests/role/ipython_notebook.pp,3,0.3333333333333333,3,0
wikimedia_puppet,modules/eventlogging/manifests/plugin.pp,3,0.5,3,0
wikimedia_puppet,modules/sysctlfile/manifests/advanced-routing.pp,1,1.0,1,0
wikimedia_puppet,modules/sysctlfile/manifests/advanced-routing-ipv6.pp,1,1.0,1,0
wikimedia_puppet,modules/sysctlfile/manifests/high-bandwidth-rsync.pp,1,1.0,1,0
wikimedia_puppet,modules/sysctlfile/manifests/ipv6-disable-ra.pp,1,1.0,1,0
wikimedia_puppet,manifests/role/analytics/kraken.pp,3,0.5789473684210527,3,0
wikimedia_puppet,manifests/role/analytics/common.pp,1,1.0,1,0
wikimedia_puppet,modules/sysctlfile/manifests/lvs.pp,1,1.0,1,0
wikimedia_puppet,manifests/role/elasticsearch.pp,23,0.18571428571428572,6,17
wikimedia_puppet,modules/elasticsearch/manifests/decommission.pp,3,0.5,3,0
wikimedia_puppet,modules/elasticsearch/manifests/init.pp,20,0.43820224719101125,3,17
wikimedia_puppet,manifests/role/analytics/hue.pp,4,0.7,4,0
wikimedia_puppet,modules/protoproxy/manifests/localssl.pp,9,0.375,9,0
wikimedia_puppet,manifests/role/ci.pp,22,0.30927835051546393,6,16
wikimedia_puppet,modules/contint/manifests/publish-console.pp,3,0.3333333333333333,3,0
wikimedia_puppet,modules/mongodb/manifests/decommission.pp,1,1.0,1,0
wikimedia_puppet,modules/interface/manifests/add_ip6_mapped.pp,9,0.5555555555555556,9,0
wikimedia_puppet,modules/interface/manifests/aggregate.pp,6,0.2857142857142857,6,0
wikimedia_puppet,modules/interface/manifests/init.pp,2,0.5,2,0
wikimedia_puppet,modules/interface/manifests/manual.pp,5,0.3333333333333333,5,0
wikimedia_puppet,modules/interface/manifests/offload.pp,6,0.2857142857142857,6,0
wikimedia_puppet,modules/interface/manifests/tagged.pp,6,0.6,6,0
wikimedia_puppet,modules/interface/manifests/tun6to4.pp,4,0.25,4,0
wikimedia_puppet,manifests/role/backup.pp,12,0.6666666666666666,3,9
wikimedia_puppet,modules/bacula/manifests/client.pp,3,0.7777777777777778,3,0
wikimedia_puppet,modules/bacula/manifests/client/job.pp,4,0.5,4,0
wikimedia_puppet,modules/bacula/manifests/client/mysql-bpipe.pp,4,0.5,4,0
wikimedia_puppet,modules/bacula/manifests/console.pp,1,1.0,1,0
wikimedia_puppet,modules/bacula/manifests/director.pp,2,0.875,2,0
wikimedia_puppet,modules/bacula/manifests/director/catalog.pp,1,1.0,1,0
wikimedia_puppet,modules/bacula/manifests/director/fileset.pp,1,1.0,1,0
wikimedia_puppet,modules/bacula/manifests/director/jobdefaults.pp,1,1.0,1,0
wikimedia_puppet,modules/bacula/manifests/director/pool.pp,1,1.0,1,0
wikimedia_puppet,modules/bacula/manifests/director/schedule.pp,1,1.0,1,0
wikimedia_puppet,modules/bacula/manifests/init.pp,1,1.0,1,0
wikimedia_puppet,modules/bacula/manifests/storage.pp,2,0.75,2,0
wikimedia_puppet,modules/bacula/manifests/storage/device.pp,2,0.6666666666666666,2,0
wikimedia_puppet,modules/bacula/tests/client.pp,4,0.5,4,0
wikimedia_puppet,modules/bacula/tests/console.pp,2,0.5,2,0
wikimedia_puppet,modules/bacula/tests/director.pp,4,0.25,4,0
wikimedia_puppet,modules/bacula/tests/init.pp,1,1.0,1,0
wikimedia_puppet,modules/bacula/tests/storage.pp,3,0.3333333333333333,3,0
wikimedia_puppet,modules/gitconfig/manifests/user.pp,1,1.0,1,0
wikimedia_puppet,modules/interface/manifests/ip.pp,3,0.75,3,0
wikimedia_puppet,modules/interface/manifests/up_command.pp,3,0.3333333333333333,3,0
wikimedia_puppet,manifests/role/otrs.pp,17,0.5631067961165048,2,15
wikimedia_puppet,modules/labsproxy/manifests/init.pp,1,1.0,1,0
wikimedia_puppet,modules/ferm/manifests/conf.pp,5,0.2,5,0
wikimedia_puppet,modules/ferm/manifests/init.pp,8,0.3333333333333333,8,0
wikimedia_puppet,modules/ferm/manifests/rule.pp,4,0.42857142857142855,4,0
wikimedia_puppet,modules/ferm/manifests/service.pp,4,0.25,4,0
wikimedia_puppet,modules/ceph/manifests/nagios.pp,2,0.5,2,0
wikimedia_puppet,modules/nrpe/manifests/check.pp,3,0.4,3,0
wikimedia_puppet,modules/nrpe/manifests/init.pp,11,0.42857142857142855,3,8
wikimedia_puppet,modules/nrpe/manifests/monitor_service.pp,8,0.18181818181818182,8,0
wikimedia_puppet,modules/nrpe/manifests/packages.pp,1,1.0,1,0
wikimedia_puppet,modules/nrpe/manifests/service.pp,1,1.0,1,0
wikimedia_puppet,modules/nrpe/spec/fixtures/manifests/site.pp,2,0.5,2,0
wikimedia_puppet,modules/nrpe/tests/check.pp,1,1.0,1,0
wikimedia_puppet,modules/nrpe/tests/monitor_service.pp,1,1.0,1,0
wikimedia_puppet,modules/nrpe/tests/nrpe.pp,2,0.5,2,0
wikimedia_puppet,modules/nrpe/tests/packages.pp,1,1.0,1,0
wikimedia_puppet,modules/nrpe/tests/service.pp,1,1.0,1,0
wikimedia_puppet,modules/coredb_mysql/manifests/purge_slow_digest.pp,3,0.3333333333333333,3,0
wikimedia_puppet,modules/varnish/manifests/monitoring/ganglia/vhtcpd.pp,5,0.3333333333333333,5,0
wikimedia_puppet,manifests/monitoring/ganglia/vhtcpd.pp,4,0.25,4,0
wikimedia_puppet,manifests/role/authdns.pp,5,0.5172413793103449,3,2
wikimedia_puppet,modules/authdns/manifests/account.pp,7,0.4166666666666667,7,0
wikimedia_puppet,modules/authdns/manifests/init.pp,6,0.4,6,0
wikimedia_puppet,modules/authdns/manifests/monitoring.pp,4,0.4,4,0
wikimedia_puppet,modules/authdns/manifests/scripts.pp,6,0.2857142857142857,6,0
wikimedia_puppet,modules/authdns/manifests/ganglia.pp,1,1.0,1,0
wikimedia_puppet,modules/nginx/manifests/package.pp,1,1.0,1,0
wikimedia_puppet,modules/nginx/manifests/service.pp,1,1.0,1,0
wikimedia_puppet,manifests/labs/bots/bots.pp,2,0.5,2,0
wikimedia_puppet,modules/elasticsearch/manifests/ganglia.pp,4,0.25,4,0
wikimedia_puppet,modules/pystatsd/manifests/init.pp,1,1.0,1,0
wikimedia_puppet,modules/solr/manifests/decommission.pp,1,1.0,1,0
wikimedia_puppet,modules/base/manifests/environment.pp,8,0.42105263157894735,8,0
wikimedia_puppet,modules/base/manifests/init.pp,31,0.1875,5,26
wikimedia_puppet,modules/base/manifests/monitoring/host.pp,20,0.22340425531914893,7,13
wikimedia_puppet,modules/base/manifests/motd.pp,1,1.0,1,0
wikimedia_puppet,modules/base/manifests/platform.pp,4,0.42857142857142855,4,0
wikimedia_puppet,modules/base/manifests/resolving.pp,8,0.2857142857142857,8,0
wikimedia_puppet,modules/base/manifests/standard-packages.pp,16,0.2926829268292683,6,10
wikimedia_puppet,modules/base/manifests/sysctl.pp,9,0.18181818181818182,9,0
wikimedia_puppet,modules/base/manifests/vimconfig.pp,2,0.75,2,0
wikimedia_puppet,modules/statsd/manifests/init.pp,5,0.5555555555555556,5,0
wikimedia_puppet,modules/mediawiki/manifests/monitor/errors.pp,1,1.0,1,0
wikimedia_puppet,modules/sysctl/manifests/conffile.pp,6,0.3333333333333333,6,0
wikimedia_puppet,modules/sysctl/manifests/init.pp,6,0.2857142857142857,6,0
wikimedia_puppet,modules/sysctl/manifests/parameters.pp,3,0.5,3,0
wikimedia_puppet,modules/authdns/manifests/lint.pp,3,0.5,3,0
wikimedia_puppet,modules/contint/manifests/firewall.pp,10,0.36363636363636365,6,4
wikimedia_puppet,manifests/role/analytics/kafka.pp,13,0.42105263157894735,2,11
wikimedia_puppet,modules/contint/manifests/zuul/git-daemon.pp,1,1.0,1,0
wikimedia_puppet,modules/dynamicproxy/manifests/init.pp,19,0.25675675675675674,6,13
wikimedia_puppet,modules/elasticsearch/manifests/nagios/check.pp,4,0.5,4,0
wikimedia_puppet,modules/elasticsearch/manifests/nagios/plugin.pp,6,0.3,6,0
wikimedia_puppet,manifests/netmapper_update.pp,4,0.5555555555555556,4,0
wikimedia_puppet,modules/varnish/manifests/netmapper_update.pp,4,0.5555555555555556,4,0
wikimedia_puppet,modules/webperf/manifests/init.pp,4,0.5,4,0
wikimedia_puppet,modules/labsvagrant/manifests/init.pp,1,1.0,1,0
wikimedia_puppet,manifests/role/labsvagrant.pp,4,0.3333333333333333,4,0
wikimedia_puppet,manifests/role/labsbastion.pp,8,0.3,8,0
wikimedia_puppet,modules/deployment/manifests/packages.pp,4,0.25,4,0
wikimedia_puppet,modules/git/manifests/clone.pp,12,0.28,4,8
wikimedia_puppet,modules/git/manifests/userconfig.pp,2,0.5,2,0
wikimedia_puppet,modules/labs_vagrant/manifests/init.pp,10,0.2222222222222222,10,0
wikimedia_puppet,modules/gdash/manifests/init.pp,5,0.6,5,0
wikimedia_puppet,modules/contint/manifests/localvhost.pp,7,0.2857142857142857,7,0
wikimedia_puppet,modules/contint/manifests/browsertests.pp,9,0.32,6,3
wikimedia_puppet,modules/jenkins/manifests/slave/requisites.pp,4,0.4,4,0
wikimedia_puppet,modules/bacula/spec/fixtures/manifests/site.pp,2,0.5,2,0
wikimedia_puppet,modules/contint/manifests/slave-scripts.pp,10,0.2857142857142857,10,0
wikimedia_puppet,modules/miredo/manifests/init.pp,3,0.5,3,0
wikimedia_puppet,modules/drac/manifests/init.pp,3,0.3333333333333333,3,0
wikimedia_puppet,manifests/role/labsvmbuilder.pp,2,0.6666666666666666,2,0
wikimedia_puppet,modules/labs_vmbuilder/manifests/init.pp,8,0.36666666666666664,5,3
wikimedia_puppet,manifests/role/statsd.pp,4,0.375,4,0
wikimedia_puppet,modules/puppet_statsd/manifests/init.pp,3,0.3333333333333333,3,0
wikimedia_puppet,modules/toollabs/manifests/webnode.pp,7,0.6470588235294118,7,0
wikimedia_puppet,modules/gridengine/manifests/exec_submit_host.pp,2,0.75,2,0
wikimedia_puppet,modules/ssh/manifests/client.pp,5,0.3333333333333333,5,0
wikimedia_puppet,modules/ssh/manifests/hostkey.pp,2,0.6666666666666666,2,0
wikimedia_puppet,modules/ssh/manifests/hostkeys-collect.pp,4,0.5,4,0
wikimedia_puppet,modules/ssh/manifests/init.pp,2,0.5,2,0
wikimedia_puppet,modules/ssh/manifests/server.pp,9,0.3,7,2
wikimedia_puppet,modules/bastion/manifests/init.pp,1,1.0,1,0
wikimedia_puppet,modules/bastionhost/manifests/init.pp,7,0.14285714285714285,7,0
wikimedia_puppet,modules/drac/tests/drac.pp,2,0.5,2,0
wikimedia_puppet,modules/mysql_wmf/manifests/client/default_charset_binary.pp,2,0.5,2,0
wikimedia_puppet,modules/mysql_wmf/manifests/conf.pp,2,0.5,2,0
wikimedia_puppet,modules/mysql_wmf/manifests/coredb/ganglia.pp,4,0.25,4,0
wikimedia_puppet,modules/mysql_wmf/manifests/coredb/monitoring.pp,6,0.16666666666666666,6,0
wikimedia_puppet,modules/mysql_wmf/manifests/ganglia.pp,4,0.4,4,0
wikimedia_puppet,modules/mysql_wmf/manifests/init.pp,7,0.3333333333333333,7,0
wikimedia_puppet,modules/mysql_wmf/manifests/monitor/percona.pp,6,0.16666666666666666,6,0
wikimedia_puppet,modules/mysql_wmf/manifests/monitor/percona/files.pp,3,0.5,3,0
wikimedia_puppet,modules/mysql_wmf/manifests/packages.pp,5,0.2,5,0
wikimedia_puppet,modules/mysql/manifests/apparmorservice.pp,1,1.0,1,0
wikimedia_puppet,modules/download/manifests/gluster.pp,4,0.3333333333333333,4,0
wikimedia_puppet,modules/download/manifests/mediawiki.pp,6,0.16666666666666666,6,0
wikimedia_puppet,modules/download/manifests/mirror.pp,4,0.4,4,0
wikimedia_puppet,modules/download/manifests/primary.pp,4,0.4,4,0
wikimedia_puppet,modules/download/manifests/wikimedia.pp,8,0.2727272727272727,8,0
wikimedia_puppet,modules/uwsgi/manifests/app.pp,6,0.3333333333333333,6,0
wikimedia_puppet,modules/uwsgi/manifests/init.pp,7,0.2631578947368421,7,0
wikimedia_puppet,modules/graphite/manifests/web.pp,10,0.3333333333333333,4,6
wikimedia_puppet,modules/puppetmaster/manifests/gitpuppet.pp,5,0.5,5,0
wikimedia_puppet,modules/download/manifests/cron-rsync-dumps.pp,4,0.25,4,0
wikimedia_puppet,modules/download/manifests/init.pp,2,0.5,2,0
wikimedia_puppet,modules/download/manifests/kiwix.pp,2,0.5,2,0
wikimedia_puppet,modules/dynamicproxy/manifests/api.pp,9,0.25806451612903225,5,4
wikimedia_puppet,modules/gluster/manifests/client.pp,1,1.0,1,0
wikimedia_puppet,modules/gluster/manifests/server.pp,1,1.0,1,0
wikimedia_puppet,modules/gluster/manifests/service.pp,1,1.0,1,0
wikimedia_puppet,modules/system/manifests/role.pp,8,0.2222222222222222,8,0
wikimedia_puppet,modules/generic/manifests/debconf/set.pp,1,1.0,1,0
wikimedia_puppet,modules/generic/manifests/higher_min_free_kbytes.pp,1,1.0,1,0
wikimedia_puppet,modules/generic/manifests/locales/international.pp,1,1.0,1,0
wikimedia_puppet,modules/generic/manifests/systemuser.pp,4,0.5,4,0
wikimedia_puppet,modules/generic/manifests/upstart_job.pp,5,0.3333333333333333,5,0
wikimedia_puppet,modules/generic/manifests/wikidev-umask.pp,1,1.0,1,0
wikimedia_puppet,modules/puppet/manifests/self/client.pp,4,0.4,4,0
wikimedia_puppet,modules/puppet/manifests/self/config.pp,9,0.3235294117647059,7,2
wikimedia_puppet,modules/puppet/manifests/self/gitclone.pp,9,0.2,9,0
wikimedia_puppet,modules/puppet/manifests/self/master.pp,13,0.2222222222222222,6,7
wikimedia_puppet,modules/puppet/tests/client.pp,2,0.6666666666666666,2,0
wikimedia_puppet,modules/puppet/tests/config.pp,2,0.6666666666666666,2,0
wikimedia_puppet,modules/puppet/tests/gitclone.pp,2,0.5,2,0
wikimedia_puppet,modules/puppet/tests/master.pp,2,0.75,2,0
wikimedia_puppet,modules/puppetmaster/manifests/config.pp,4,0.5,4,0
wikimedia_puppet,modules/puppetmaster/manifests/geoip.pp,5,0.65,5,0
wikimedia_puppet,modules/puppetmaster/manifests/gitclone.pp,11,0.3409090909090909,4,7
wikimedia_puppet,modules/puppetmaster/manifests/init.pp,15,0.30120481927710846,5,10
wikimedia_puppet,modules/puppetmaster/manifests/labs.pp,8,0.3,8,0
wikimedia_puppet,modules/puppetmaster/manifests/passenger.pp,15,0.25,5,10
wikimedia_puppet,modules/puppetmaster/manifests/scripts.pp,10,0.2962962962962963,4,6
wikimedia_puppet,modules/puppetmaster/manifests/ssl.pp,6,0.3,6,0
wikimedia_puppet,modules/puppetmaster/tests/geoip.pp,2,0.5,2,0
wikimedia_puppet,modules/puppetmaster/tests/gitpuppet.pp,2,0.5,2,0
wikimedia_puppet,modules/puppetmaster/tests/labs.pp,2,0.5,2,0
wikimedia_puppet,modules/puppetmaster/tests/passenger.pp,2,0.75,2,0
wikimedia_puppet,modules/puppetmaster/tests/puppetmaster.pp,4,0.5,4,0
wikimedia_puppet,modules/puppetmaster/tests/scripts.pp,2,0.5,2,0
wikimedia_puppet,modules/puppetmaster/tests/ssl.pp,2,0.5,2,0
wikimedia_puppet,modules/geoip/manifests/data/lite.pp,2,0.75,2,0
wikimedia_puppet,modules/geoip/manifests/bin.pp,1,1.0,1,0
wikimedia_puppet,manifests/role/graphite.pp,20,0.26,5,15
wikimedia_puppet,modules/graphite/manifests/init.pp,7,0.5769230769230769,4,3
wikimedia_puppet,modules/contint/manifests/android-sdk.pp,1,1.0,1,0
wikimedia_puppet,modules/toollabs/manifests/proxy.pp,18,0.32,3,15
wikimedia_puppet,manifests/role/ocg.pp,20,0.21818181818181817,4,16
wikimedia_puppet,manifests/role/ircd.pp,2,0.5,2,0
wikimedia_puppet,modules/ircd/manifests/mediawiki-irc-relay.pp,2,0.5,2,0
wikimedia_puppet,modules/ircd/manifests/server.pp,2,0.5,2,0
wikimedia_puppet,manifests/role/parsoid.pp,22,0.18181818181818182,5,17
wikimedia_puppet,modules/contint/manifests/packages/labs.pp,18,0.2631578947368421,6,12
wikimedia_puppet,manifests/role/gdash.pp,5,0.7777777777777778,3,2
wikimedia_puppet,manifests/role/haproxy.pp,3,0.5,3,0
wikimedia_puppet,manifests/role/download.pp,4,0.5,4,0
wikimedia_puppet,modules/nginx/manifests/site.pp,1,1.0,1,0
wikimedia_puppet,manifests/role/mwprof.pp,3,0.6,3,0
wikimedia_puppet,modules/mwprof/manifests/init.pp,2,0.8,2,0
wikimedia_puppet,manifests/role/logstash.pp,22,0.14102564102564102,9,13
wikimedia_puppet,modules/bugzilla/manifests/apache.pp,5,0.5714285714285714,5,0
wikimedia_puppet,modules/bugzilla/manifests/init.pp,6,0.32,3,3
wikimedia_puppet,modules/bugzilla/manifests/logmail.pp,3,0.6,3,0
wikimedia_puppet,modules/bugzilla/manifests/reporter.pp,6,0.2222222222222222,6,0
wikimedia_puppet,manifests/role/wikimania_scholarships.pp,9,0.2,9,0
wikimedia_puppet,modules/wikimania_scholarships/manifests/init.pp,11,0.24,6,5
wikimedia_puppet,modules/graphite/manifests/web/nginx.pp,1,1.0,1,0
wikimedia_puppet,modules/gdash/manifests/nginx.pp,1,1.0,1,0
wikimedia_puppet,modules/apache/manifests/mod/uwsgi.pp,1,1.0,1,0
wikimedia_puppet,manifests/role/install-server.pp,4,0.7058823529411765,4,0
wikimedia_puppet,modules/install-server/manifests/apt-repository.pp,3,0.3333333333333333,3,0
wikimedia_puppet,modules/install-server/manifests/caching-proxy.pp,2,0.6666666666666666,2,0
wikimedia_puppet,modules/install-server/manifests/dhcp-server.pp,4,0.5,4,0
wikimedia_puppet,modules/install-server/manifests/preseed-server.pp,1,1.0,1,0
wikimedia_puppet,modules/install-server/manifests/tftp-server.pp,3,0.6,3,0
wikimedia_puppet,modules/install-server/manifests/web-server.pp,1,1.0,1,0
wikimedia_puppet,modules/install-server/spec/fixtures/manifests/site.pp,1,1.0,1,0
wikimedia_puppet,modules/install-server/tests/apt-repository.pp,1,1.0,1,0
wikimedia_puppet,modules/install-server/tests/caching-proxy.pp,1,1.0,1,0
wikimedia_puppet,modules/install-server/tests/dhcp-server.pp,1,1.0,1,0
wikimedia_puppet,modules/install-server/tests/preseed-server.pp,1,1.0,1,0
wikimedia_puppet,modules/install-server/tests/tftp-server.pp,1,1.0,1,0
wikimedia_puppet,modules/install-server/tests/web-server.pp,1,1.0,1,0
wikimedia_puppet,modules/install-server/manifests/ubuntu-mirror.pp,1,1.0,1,0
wikimedia_puppet,modules/install-server/tests/ubuntu-mirror.pp,1,1.0,1,0
wikimedia_puppet,manifests/role/lvs.pp,10,0.1875,6,4
wikimedia_puppet,modules/lvs/manifests/balancer.pp,12,0.2222222222222222,6,6
wikimedia_puppet,modules/lvs/manifests/balancer/runcommand.pp,7,0.25,7,0
wikimedia_puppet,modules/lvs/manifests/configuration.pp,18,0.21495327102803738,6,12
wikimedia_puppet,modules/lvs/manifests/init.pp,5,0.3333333333333333,5,0
wikimedia_puppet,modules/lvs/manifests/monitor.pp,14,0.3902439024390244,6,8
wikimedia_puppet,modules/lvs/manifests/realserver.pp,3,0.3333333333333333,3,0
wikimedia_puppet,modules/memcached/manifests/config.pp,1,1.0,1,0
wikimedia_puppet,modules/memcached/manifests/ganglia.pp,4,0.4,4,0
wikimedia_puppet,modules/memcached/manifests/init.pp,11,0.2222222222222222,11,0
wikimedia_puppet,manifests/role/ishmael.pp,8,0.3,8,0
wikimedia_puppet,modules/ishmael/manifests/config.pp,1,1.0,1,0
wikimedia_puppet,modules/ishmael/manifests/init.pp,5,0.3333333333333333,5,0
wikimedia_puppet,manifests/role/echoirc.pp,3,0.5555555555555556,3,0
wikimedia_puppet,modules/ircecho/manifests/init.pp,14,0.3548387096774194,6,8
wikimedia_puppet,modules/logstash/manifests/conf.pp,4,0.5555555555555556,4,0
wikimedia_puppet,modules/logstash/manifests/init.pp,10,0.24,4,6
wikimedia_puppet,modules/logstash/manifests/input/redis.pp,3,0.5,3,0
wikimedia_puppet,modules/logstash/manifests/input/syslog.pp,4,0.2857142857142857,4,0
wikimedia_puppet,modules/logstash/manifests/input/udp2log.pp,4,0.2857142857142857,4,0
wikimedia_puppet,modules/logstash/manifests/output/elasticsearch.pp,7,0.391304347826087,6,1
wikimedia_puppet,modules/webperf/manifests/asset_check.pp,5,0.42857142857142855,5,0
wikimedia_puppet,modules/webperf/manifests/navtiming.pp,6,0.36363636363636365,6,0
wikimedia_puppet,modules/smokeping/manifests/config.pp,3,0.3333333333333333,3,0
wikimedia_puppet,modules/smokeping/manifests/init.pp,5,0.5555555555555556,5,0
wikimedia_puppet,modules/smokeping/manifests/web.pp,5,0.2727272727272727,5,0
wikimedia_puppet,manifests/role/librenms.pp,10,0.4838709677419355,6,4
wikimedia_puppet,modules/librenms/manifests/init.pp,9,0.32,4,5
wikimedia_puppet,modules/librenms/manifests/syslog.pp,5,0.2,5,0
wikimedia_puppet,modules/pmacct/manifests/devices.pp,1,1.0,1,0
wikimedia_puppet,modules/pmacct/manifests/init.pp,6,0.25,6,0
wikimedia_puppet,modules/pmacct/manifests/makeconfig.pp,2,0.5,2,0
wikimedia_puppet,manifests/role/kibana.pp,13,0.21428571428571427,7,6
wikimedia_puppet,modules/kibana/init.pp,1,1.0,1,0
wikimedia_puppet,modules/kibana/manifests/init.pp,6,0.2727272727272727,6,0
wikimedia_puppet,modules/ocg/manifests/decommission.pp,5,0.2857142857142857,5,0
wikimedia_puppet,modules/ocg/manifests/init.pp,20,0.2222222222222222,7,13
wikimedia_puppet,modules/txstatsd/manifests/decommission.pp,2,0.5,2,0
wikimedia_puppet,modules/txstatsd/manifests/init.pp,5,0.5,5,0
wikimedia_puppet,manifests/role/txstatsd.pp,3,0.4444444444444444,3,0
wikimedia_puppet,modules/gitblit/manifests/init.pp,7,0.3888888888888889,7,0
wikimedia_puppet,modules/gitblit/manifests/monitor.pp,2,0.5,2,0
wikimedia_puppet,modules/url-downloader/manifests/init.pp,2,0.5,2,0
wikimedia_puppet,manifests/role/webperf.pp,4,0.5,4,0
wikimedia_puppet,modules/elasticsearch/manifests/packages.pp,10,0.2631578947368421,10,0
wikimedia_puppet,modules/openstack/manifests/all.pp,1,1.0,1,0
wikimedia_puppet,modules/openstack/manifests/auth_file.pp,1,1.0,1,0
wikimedia_puppet,modules/openstack/manifests/cinder/all.pp,1,1.0,1,0
wikimedia_puppet,modules/openstack/manifests/cinder/controller.pp,1,1.0,1,0
wikimedia_puppet,modules/openstack/manifests/cinder/storage.pp,1,1.0,1,0
wikimedia_puppet,modules/openstack/manifests/client.pp,1,1.0,1,0
wikimedia_puppet,modules/openstack/manifests/compute.pp,1,1.0,1,0
wikimedia_puppet,modules/openstack/manifests/controller.pp,1,1.0,1,0
wikimedia_puppet,modules/openstack/manifests/db/mysql.pp,1,1.0,1,0
wikimedia_puppet,modules/openstack/manifests/glance.pp,1,1.0,1,0
wikimedia_puppet,modules/openstack/manifests/horizon.pp,1,1.0,1,0
wikimedia_puppet,modules/openstack/manifests/keystone.pp,1,1.0,1,0
wikimedia_puppet,modules/openstack/manifests/neutron.pp,1,1.0,1,0
wikimedia_puppet,modules/openstack/manifests/nova/controller.pp,1,1.0,1,0
wikimedia_puppet,modules/openstack/manifests/provision.pp,1,1.0,1,0
wikimedia_puppet,modules/openstack/manifests/repo.pp,5,0.3076923076923077,5,0
wikimedia_puppet,modules/openstack/manifests/repo/epel.pp,1,1.0,1,0
wikimedia_puppet,modules/openstack/manifests/repo/rdo.pp,1,1.0,1,0
wikimedia_puppet,modules/openstack/manifests/repo/uca.pp,1,1.0,1,0
wikimedia_puppet,modules/openstack/manifests/repo/yum_refresh.pp,1,1.0,1,0
wikimedia_puppet,modules/openstack/manifests/swift/device_endpoint.pp,1,1.0,1,0
wikimedia_puppet,modules/openstack/manifests/swift/proxy.pp,1,1.0,1,0
wikimedia_puppet,modules/openstack/manifests/swift/storage-node.pp,1,1.0,1,0
wikimedia_puppet,modules/openstack/manifests/test_file.pp,1,1.0,1,0
wikimedia_puppet,modules/openstack/tests/all.pp,1,1.0,1,0
wikimedia_puppet,modules/openstack/tests/auth_file.pp,1,1.0,1,0
wikimedia_puppet,modules/openstack/tests/cloudcontroller.pp,1,1.0,1,0
wikimedia_puppet,modules/openstack/tests/compute.pp,1,1.0,1,0
wikimedia_puppet,modules/openstack/tests/site.pp,1,1.0,1,0
wikimedia_puppet,modules/openstack/tests/testfile.pp,1,1.0,1,0
wikimedia_puppet,manifests/role/openstack.pp,3,0.3333333333333333,3,0
wikimedia_puppet,manifests/role/wikimetrics.pp,14,0.32558139534883723,3,11
wikimedia_puppet,manifests/role/performance.pp,5,0.5,5,0
wikimedia_puppet,modules/webperf/manifests/ve.pp,3,0.5,3,0
wikimedia_puppet,manifests/role/subversion.pp,7,0.25,7,0
wikimedia_puppet,modules/subversion/manifests/client.pp,1,1.0,1,0
wikimedia_puppet,modules/subversion/manifests/conversion.pp,1,1.0,1,0
wikimedia_puppet,modules/subversion/manifests/init.pp,5,0.2857142857142857,5,0
wikimedia_puppet,modules/subversion/manifests/viewvc.pp,1,1.0,1,0
wikimedia_puppet,modules/poolcounter/manifests/init.pp,2,0.5,2,0
wikimedia_puppet,manifests/role/neutron.pp,4,0.7241379310344828,2,2
wikimedia_puppet,modules/beta/manifests/autoupdater.pp,9,0.25,9,0
wikimedia_puppet,modules/beta/manifests/fatalmonitor.pp,1,1.0,1,0
wikimedia_puppet,modules/beta/manifests/natdestrewrite.pp,2,0.5,2,0
wikimedia_puppet,modules/beta/manifests/natfix.pp,5,0.3333333333333333,5,0
wikimedia_puppet,modules/beta/manifests/syncsiteresources.pp,2,0.5,2,0
wikimedia_puppet,manifests/role/releases.pp,12,0.2692307692307692,6,6
wikimedia_puppet,modules/releases/manifests/backups.pp,2,0.5,2,0
wikimedia_puppet,modules/releases/manifests/init.pp,8,0.5384615384615384,4,4
wikimedia_puppet,modules/releases/manifests/webserver.pp,2,0.5,2,0
wikimedia_puppet,manifests/role/tendril.pp,7,0.23809523809523808,6,1
wikimedia_puppet,modules/tendril/manifests/init.pp,9,0.35,9,0
wikimedia_puppet,manifests/role/labstools.pp,10,0.48148148148148145,3,7
wikimedia_puppet,modules/postgresql/manifests/master.pp,8,0.3333333333333333,8,0
wikimedia_puppet,modules/postgresql/manifests/postgis.pp,6,0.45454545454545453,6,0
wikimedia_puppet,modules/postgresql/manifests/server.pp,8,0.4166666666666667,6,2
wikimedia_puppet,modules/postgresql/manifests/slave.pp,8,0.5,4,4
wikimedia_puppet,modules/postgresql/manifests/spatialdb.pp,5,0.4166666666666667,5,0
wikimedia_puppet,modules/postgresql/manifests/user.pp,6,0.47058823529411764,6,0
wikimedia_puppet,modules/postgresql/spec/fixtures/manifests/site.pp,1,1.0,1,0
wikimedia_puppet,modules/postgresql/tests/master.pp,2,0.5,2,0
wikimedia_puppet,modules/postgresql/tests/postgis.pp,2,0.5,2,0
wikimedia_puppet,modules/postgresql/tests/server.pp,2,0.5,2,0
wikimedia_puppet,modules/postgresql/tests/slave.pp,2,0.5,2,0
wikimedia_puppet,modules/postgresql/tests/user.pp,2,0.5,2,0
wikimedia_puppet,modules/toollabs/manifests/gridnode.pp,2,0.875,2,0
wikimedia_puppet,modules/elasticsearch/manifests/log/hot_threads.pp,4,0.25,4,0
wikimedia_puppet,modules/geoip/manifests/dev.pp,1,1.0,1,0
wikimedia_puppet,manifests/role/osm.pp,7,0.8333333333333334,1,6
wikimedia_puppet,manifests/role/labstest.pp,2,0.75,2,0
wikimedia_puppet,modules/labs_lvm/manifest/init.pp,1,1.0,1,0
wikimedia_puppet,modules/labs_lvm/manifests/init.pp,7,0.4666666666666667,7,0
wikimedia_puppet,modules/labs_lvm/manifests/volume.pp,9,0.38095238095238093,4,5
wikimedia_puppet,manifests/role/analytics/kafkatee.pp,10,0.39285714285714285,3,7
wikimedia_puppet,manifests/role/access_new_install.pp,5,0.3333333333333333,5,0
wikimedia_puppet,modules/wikistats/manifests/cronjob.pp,2,0.6666666666666666,2,0
wikimedia_puppet,modules/wikistats/manifests/init.pp,3,0.45454545454545453,3,0
wikimedia_puppet,modules/wikistats/manifests/updates.pp,3,0.5555555555555556,3,0
wikimedia_puppet,modules/wikistats/manifests/web.pp,6,0.375,6,0
wikimedia_puppet,modules/contint/manifests/maven_settings.pp,1,1.0,1,0
wikimedia_puppet,modules/contint/manifests/maven_webproxy.pp,1,1.0,1,0
wikimedia_puppet,manifests/role/labsdb.pp,7,0.4166666666666667,7,0
wikimedia_puppet,modules/applicationserver/manifests/hhvm.pp,3,0.75,3,0
wikimedia_puppet,manifests/role/dataset.pp,11,0.3333333333333333,7,4
wikimedia_puppet,modules/dataset/manifests/cron/kiwix.pp,4,0.5833333333333334,4,0
wikimedia_puppet,modules/dataset/manifests/cron/rsync/labs.pp,5,0.3076923076923077,5,0
wikimedia_puppet,modules/dataset/manifests/cron/rsync/peers.pp,4,0.6363636363636364,4,0
wikimedia_puppet,modules/dataset/manifests/init.pp,4,0.5,4,0
wikimedia_puppet,modules/dataset/manifests/nfs.pp,8,0.26666666666666666,8,0
wikimedia_puppet,modules/dataset/manifests/rsync/common.pp,3,0.5,3,0
wikimedia_puppet,modules/dataset/manifests/rsync/default.pp,4,0.3333333333333333,4,0
wikimedia_puppet,modules/dataset/manifests/rsync/pagecounts.pp,3,0.6,3,0
wikimedia_puppet,modules/dataset/manifests/rsync/peers.pp,4,0.5,4,0
wikimedia_puppet,modules/dataset/manifests/rsync/public.pp,4,0.42857142857142855,4,0
wikimedia_puppet,modules/dataset/manifests/rsync/searchlogs.pp,1,1.0,1,0
wikimedia_puppet,modules/dataset/manifests/cron/pagecountsraw.pp,6,0.25,6,0
wikimedia_puppet,manifests/role/snapshot.pp,9,0.45714285714285713,4,5
wikimedia_puppet,modules/snapshot/manifests/common.pp,4,0.5,4,0
wikimedia_puppet,modules/snapshot/manifests/init.pp,2,0.5,2,0
wikimedia_puppet,modules/snapshot/manifests/packages.pp,4,0.5,4,0
wikimedia_puppet,modules/snapshot/manifests/phpfiles.pp,1,1.0,1,0
wikimedia_puppet,modules/snapshot/manifests/sync.pp,2,0.6666666666666666,2,0
wikimedia_puppet,modules/planet/manifests/apachesite.pp,4,0.4,4,0
wikimedia_puppet,modules/mwprof/manifests/reporter.pp,1,1.0,1,0
wikimedia_puppet,modules/snapshot/manifests/dirs.pp,4,0.4,4,0
wikimedia_puppet,modules/snapshot/manifests/dumps.pp,3,0.5833333333333334,3,0
wikimedia_puppet,modules/snapshot/manifests/dumps/configs.pp,3,0.5,2,1
wikimedia_puppet,modules/snapshot/manifests/dumps/dblists.pp,3,0.47619047619047616,2,1
wikimedia_puppet,modules/snapshot/manifests/dumps/templates.pp,2,0.75,2,0
wikimedia_puppet,modules/snapshot/manifests/dumps/wikiconf.pp,2,0.8,2,0
wikimedia_puppet,modules/snapshot/manifests/dumps/pagetitles.pp,4,0.7777777777777778,4,0
wikimedia_puppet,modules/snapshot/manifests/addschanges.pp,3,0.7272727272727273,3,0
wikimedia_puppet,modules/snapshot/manifests/addschanges/config.pp,2,0.6666666666666666,2,0
wikimedia_puppet,modules/snapshot/manifests/addschanges/templates.pp,2,0.6666666666666666,2,0
wikimedia_puppet,modules/postgresql/tests/spatial.pp,2,0.5,2,0
wikimedia_puppet,modules/snapshot/manifests/dumps/dumplists.pp,3,0.5,3,0
wikimedia_puppet,modules/snapshot/manifests/dumps/mediadirlists.pp,3,0.5,3,0
wikimedia_puppet,manifests/misc/rt.pp,3,0.6,3,0
wikimedia_puppet,manifests/role/rt.pp,5,0.5,5,0
wikimedia_puppet,manifests/role/labsmnt.pp,3,0.3333333333333333,3,0
wikimedia_puppet,modules/osm/manifests/packages.pp,1,1.0,1,0
wikimedia_puppet,modules/osm/manifests/populatedb.pp,1,1.0,1,0
wikimedia_puppet,modules/osm/manifests/usergrants.pp,1,1.0,1,0
wikimedia_puppet,modules/osm/spec/fixtures/manifests/site.pp,2,0.5,2,0
wikimedia_puppet,modules/puppet/manifests/self/geoip.pp,3,0.5,3,0
wikimedia_puppet,modules/snapshot/manifests/centralauthdump.pp,4,0.25,4,0
wikimedia_puppet,modules/spamassassin/manifests/init.pp,5,0.5,5,0
wikimedia_puppet,modules/clamav/manifests/init.pp,4,0.4,4,0
wikimedia_puppet,modules/toollabs/manifests/submit.pp,9,0.34782608695652173,3,6
wikimedia_puppet,modules/toollabs/manifests/hba.pp,6,0.2857142857142857,6,0
wikimedia_puppet,modules/snapshot/manifests/mediaperprojectlists.pp,3,0.5,3,0
wikimedia_puppet,manifests/role/archiva.pp,6,0.3125,6,0
wikimedia_puppet,modules/archiva/manifests/gitfat.pp,6,0.16666666666666666,6,0
wikimedia_puppet,modules/archiva/manifests/init.pp,1,1.0,1,0
wikimedia_puppet,manifests/role/mariadb.pp,20,0.3314917127071823,5,15
wikimedia_puppet,modules/mariadb/manifests/config.pp,5,0.5,5,0
wikimedia_puppet,modules/mariadb/manifests/init.pp,2,0.6666666666666666,2,0
wikimedia_puppet,modules/mariadb/manifests/packages.pp,3,0.6,3,0
wikimedia_puppet,manifests/role/syslog.pp,4,0.4,4,0
wikimedia_puppet,manifests/role/package.pp,5,0.42857142857142855,5,0
wikimedia_puppet,manifests/role/labssrv.pp,1,1.0,1,0
wikimedia_puppet,modules/mariadb/manifests/monitor_disk.pp,4,0.25,4,0
wikimedia_puppet,modules/mariadb/manifests/monitor_process.pp,2,0.5,2,0
wikimedia_puppet,modules/mariadb/manifests/packages_wmf.pp,3,0.6363636363636364,3,0
wikimedia_puppet,manifests/role/pmacct.pp,4,0.5714285714285714,4,0
wikimedia_puppet,modules/pmacct/manifests/configs.pp,2,0.5,2,0
wikimedia_puppet,modules/pmacct/manifests/install.pp,3,0.3333333333333333,3,0
wikimedia_puppet,modules/eventlogging/manifests/service/reporter.pp,5,0.3333333333333333,5,0
wikimedia_puppet,modules/hhvm/manifests/backports.pp,1,1.0,1,0
wikimedia_puppet,modules/hhvm/manifests/init.pp,15,0.35398230088495575,3,12
wikimedia_puppet,modules/diamond/manifests/init.pp,15,0.21951219512195122,5,10
wikimedia_puppet,modules/diamond/manifests/collector.pp,9,0.23529411764705882,9,0
wikimedia_puppet,modules/logster/manifests/init.pp,1,1.0,1,0
wikimedia_puppet,modules/logster/manifests/job.pp,2,0.6666666666666666,2,0
wikimedia_puppet,modules/osm/manifests/planet_import.pp,2,0.8,2,0
wikimedia_puppet,modules/osm/manifests/shapefile_import.pp,2,0.5,2,0
wikimedia_puppet,manifests/role/labsbiglogs.pp,2,0.5,2,0
wikimedia_puppet,modules/beta/manifests/config.pp,5,0.2857142857142857,5,0
wikimedia_puppet,modules/beta/manifests/mwdeploy_sudo.pp,3,0.3333333333333333,3,0
wikimedia_puppet,modules/beta/manifests/scap/master.pp,6,0.2222222222222222,6,0
wikimedia_puppet,modules/beta/manifests/scap/rsync_slave.pp,2,0.6666666666666666,2,0
wikimedia_puppet,modules/beta/manifests/scap/target.pp,5,0.375,5,0
wikimedia_puppet,modules/webperf/manifests/deprecate.pp,1,1.0,1,0
wikimedia_puppet,manifests/role/tcpircbot.pp,7,0.32,6,1
wikimedia_puppet,modules/interface/manifests/rps.pp,6,0.42857142857142855,4,2
wikimedia_puppet,modules/androidsdk/manifests/dependencies.pp,3,0.3333333333333333,3,0
wikimedia_puppet,modules/hhvm/manifests/dev.pp,2,0.75,2,0
wikimedia_puppet,manifests/role/puppetmaster.pp,9,0.3181818181818182,6,3
wikimedia_puppet,manifests/role/apachesync.pp,4,0.25,4,0
wikimedia_puppet,modules/apachesync/manifests/init.pp,4,0.5555555555555556,4,0
wikimedia_puppet,modules/varnish/manifests/zero_update.pp,8,0.35714285714285715,8,0
wikimedia_puppet,manifests/zero_update.pp,1,1.0,1,0
wikimedia_puppet,modules/mariadb/manifests/monitor_replication.pp,4,0.4,4,0
wikimedia_puppet,modules/diamond/manifests/generic.pp,1,1.0,1,0
wikimedia_puppet,manifests/role/diamond.pp,11,0.21739130434782608,7,4
wikimedia_puppet,manifests/role/rcstream.pp,10,0.25,6,4
wikimedia_puppet,modules/rcstream/manifests/init.pp,4,0.3333333333333333,4,0
wikimedia_puppet,modules/rcstream/manifests/proxy.pp,2,0.5,2,0
wikimedia_puppet,modules/protoproxy/manifests/params.pp,1,1.0,1,0
wikimedia_puppet,modules/logstash/manifests/input/irc.pp,2,0.6666666666666666,2,0
wikimedia_puppet,modules/twemproxy/manifests/init.pp,1,1.0,1,0
wikimedia_puppet,modules/beta/manifests/hhvm.pp,2,0.6666666666666666,2,0
wikimedia_puppet,modules/beta/manifests/common.pp,4,0.3333333333333333,4,0
wikimedia_puppet,manifests/role/mediawiki.pp,17,0.3353658536585366,4,13
wikimedia_puppet,modules/mediawiki/manifests/config/apache.pp,1,1.0,1,0
wikimedia_puppet,modules/mediawiki/manifests/config/base.pp,1,1.0,1,0
wikimedia_puppet,modules/mediawiki/manifests/config/php.pp,2,0.5,2,0
wikimedia_puppet,modules/mediawiki/manifests/pybal_check.pp,1,1.0,1,0
wikimedia_puppet,modules/mediawiki/manifests/service.pp,1,1.0,1,0
wikimedia_puppet,modules/mediawiki/manifests/syslog.pp,3,0.42857142857142855,3,0
wikimedia_puppet,modules/git/manifests/install.pp,6,0.36363636363636365,6,0
wikimedia_puppet,modules/puppet_compiler/manifests/bundle.pp,2,0.5,2,0
wikimedia_puppet,modules/puppet_compiler/manifests/differ.pp,2,0.75,2,0
wikimedia_puppet,modules/puppet_compiler/manifests/init.pp,6,0.6842105263157895,5,1
wikimedia_puppet,modules/puppet_compiler/manifests/packages.pp,3,0.6666666666666666,3,0
wikimedia_puppet,modules/admin/manifests/group.pp,3,0.5714285714285714,3,0
wikimedia_puppet,modules/admin/manifests/groupmembers.pp,5,0.5,5,0
wikimedia_puppet,modules/admin/manifests/hashgroup.pp,4,0.25,4,0
wikimedia_puppet,modules/admin/manifests/hashuser.pp,4,0.4,4,0
wikimedia_puppet,modules/admin/manifests/init.pp,6,0.3076923076923077,6,0
wikimedia_puppet,modules/admin/manifests/sudo.pp,3,0.6,3,0
wikimedia_puppet,modules/admin/manifests/user.pp,7,0.36363636363636365,7,0
wikimedia_puppet,manifests/role/puppet_compiler.pp,2,0.9,2,0
wikimedia_puppet,manifests/role/mw-rc-irc.pp,4,0.5,4,0
wikimedia_puppet,modules/mw-rc-irc/manifests/apache.pp,3,0.5,3,0
wikimedia_puppet,modules/mw-rc-irc/manifests/irc-echo.pp,3,0.3333333333333333,3,0
wikimedia_puppet,modules/mw-rc-irc/manifests/ircserver.pp,7,0.36363636363636365,7,0
wikimedia_puppet,modules/mediawiki/manifests/web.pp,9,0.453125,3,6
wikimedia_puppet,modules/contint/manifests/firewall/labs.pp,4,0.42857142857142855,4,0
wikimedia_puppet,modules/postgresql/manifests/ganglia.pp,3,0.6,3,0
wikimedia_puppet,modules/postgresql/tests/ganglia.pp,2,0.6666666666666666,2,0
wikimedia_puppet,modules/apt/manifests/puppet.pp,3,0.7142857142857143,3,0
wikimedia_puppet,modules/mediawiki/manifests/php.pp,14,0.2916666666666667,3,11
wikimedia_puppet,modules/puppetmaster/manifests/naggen2.pp,2,0.8333333333333334,2,0
wikimedia_puppet,modules/interface/manifests/rpstools.pp,3,0.5,3,0
wikimedia_puppet,modules/irqbalance/manifests/disable.pp,3,0.3333333333333333,3,0
wikimedia_puppet,modules/irqbalance/manifests/init.pp,2,0.5,2,0
wikimedia_puppet,modules/interface/manifests/txqueuelen.pp,5,0.3333333333333333,5,0
wikimedia_puppet,modules/diamond/manifests/collector/nginx.pp,2,0.5,2,0
wikimedia_puppet,manifests/role/analytics/refinery.pp,8,0.42,2,6
wikimedia_puppet,modules/vm/manifests/higher_min_free_kbytes.pp,2,0.5,2,0
wikimedia_puppet,modules/vm/manifests/min_free_kbytes.pp,2,0.75,2,0
wikimedia_puppet,modules/interface/manifests/ring.pp,5,0.3333333333333333,5,0
wikimedia_puppet,modules/interface/manifests/setting.pp,2,0.5,2,0
wikimedia_puppet,modules/mediawiki/manifests/monitor/graphite.pp,1,1.0,1,0
wikimedia_puppet,modules/toollabs/manifests/mongo.pp,1,1.0,1,0
wikimedia_puppet,modules/mediawiki/manifests/mwlogdir.pp,1,1.0,1,0
wikimedia_puppet,modules/apache/manifests/monitoring.pp,8,0.3157894736842105,8,0
wikimedia_puppet,modules/twemproxy/manifests/monitoring.pp,2,0.5,2,0
wikimedia_puppet,modules/zuul/manifests/merger.pp,9,0.21739130434782608,7,2
wikimedia_puppet,modules/zuul/manifests/server.pp,10,0.23809523809523808,5,5
wikimedia_puppet,modules/eventlogging/manifests/graphite.pp,1,1.0,1,0
wikimedia_puppet,modules/eventlogging/manifests/monitor/graphite.pp,1,1.0,1,0
wikimedia_puppet,modules/mediawiki/manifests/jobqueue.pp,3,0.3333333333333333,3,0
wikimedia_puppet,modules/eventlogging/manifests/monitoring.pp,11,0.2,11,0
wikimedia_puppet,modules/mediawiki/manifests/monitoring/errors.pp,3,0.6,3,0
wikimedia_puppet,modules/mediawiki/manifests/monitoring/graphite.pp,5,0.45454545454545453,5,0
wikimedia_puppet,modules/mediawiki/manifests/multimedia.pp,6,0.45454545454545453,4,2
wikimedia_puppet,modules/logstash/manifests/input/gelf.pp,3,0.5,3,0
wikimedia_puppet,manifests/role/puppetproxy.pp,1,1.0,1,0
wikimedia_puppet,modules/monitoring/manifests/icinga/git_merge.pp,3,0.625,3,0
wikimedia_puppet,modules/puppetmaster/manifests/monitoring.pp,4,0.4,4,0
wikimedia_puppet,manifests/role/mail.pp,13,0.4861111111111111,3,10
wikimedia_puppet,modules/exim4/manifests/dkim.pp,2,0.6666666666666666,2,0
wikimedia_puppet,modules/exim4/manifests/ganglia.pp,1,1.0,1,0
wikimedia_puppet,modules/exim4/manifests/init.pp,3,0.42857142857142855,3,0
wikimedia_puppet,modules/stdlib/tests/has_interface_with.pp,1,1.0,1,0
wikimedia_puppet,modules/stdlib/tests/has_ip_address.pp,1,1.0,1,0
wikimedia_puppet,modules/stdlib/tests/has_ip_network.pp,1,1.0,1,0
wikimedia_puppet,modules/rsyslog/manifests/conf.pp,4,0.4,4,0
wikimedia_puppet,modules/rsyslog/manifests/init.pp,4,0.25,4,0
wikimedia_puppet,modules/apache/manifests/mod_conf.pp,4,0.5,4,0
wikimedia_puppet,manifests/role/labsswiftpartition.pp,2,0.5,2,0
wikimedia_puppet,modules/phabricator/manifests/init.pp,12,0.2903225806451613,3,9
wikimedia_puppet,modules/apache/manifests/site.pp,2,0.5,2,0
wikimedia_puppet,modules/base/manifests/puppet.pp,14,0.20930232558139536,5,9
wikimedia_puppet,modules/base/manifests/puppet/params.pp,3,0.4,3,0
wikimedia_puppet,manifests/role/cxserver.pp,6,0.42857142857142855,3,3
wikimedia_puppet,modules/cxserver/manifests/init.pp,9,0.4594594594594595,6,3
wikimedia_puppet,modules/cxserver/tests/cxserver.pp,2,0.5,2,0
wikimedia_puppet,modules/rcstream/manifests/proxy/ssl.pp,5,0.4,5,0
wikimedia_puppet,modules/apache/manifests/def.pp,3,0.5,3,0
wikimedia_puppet,modules/apache/manifests/conf.pp,6,0.4666666666666667,6,0
wikimedia_puppet,manifests/role/phabricator.pp,21,0.3310810810810811,4,17
wikimedia_puppet,modules/diamond/manifests/collector/minimalpuppetagent.pp,8,0.18181818181818182,8,0
wikimedia_puppet,modules/mediawiki/manifests/monitoring/webserver.pp,7,0.6666666666666666,3,4
wikimedia_puppet,modules/nutcracker/manifests/init.pp,7,0.42105263157894735,7,0
wikimedia_puppet,modules/nutcracker/manifests/monitoring.pp,4,0.42857142857142855,4,0
wikimedia_puppet,modules/zuul/manifests/configfile.pp,1,1.0,1,0
wikimedia_puppet,modules/mediawiki/manifests/web/config.pp,3,0.6666666666666666,3,0
wikimedia_puppet,modules/zuul/manifests/monitoring/server.pp,3,0.5,3,0
wikimedia_puppet,modules/zuul/manifests/monitoring/merger.pp,2,0.7142857142857143,2,0
wikimedia_puppet,modules/twemproxy/manifests/decom.pp,1,1.0,1,0
wikimedia_puppet,modules/mediawiki/manifests/web/sites.pp,9,0.42857142857142855,9,0
wikimedia_puppet,modules/apparmor/manifests/hardlink.pp,3,0.3333333333333333,3,0
wikimedia_puppet,modules/apparmor/manifests/init.pp,3,0.3333333333333333,3,0
wikimedia_puppet,modules/phabricator/manifests/mail.pp,1,1.0,1,0
wikimedia_puppet,modules/snapshot/manifests/wikidatajsondumps.pp,1,1.0,1,0
wikimedia_puppet,modules/snapshot/manifests/wikidatajsondump.pp,2,0.8,2,0
wikimedia_puppet,modules/puppetception/manifests/init.pp,5,0.3333333333333333,5,0
wikimedia_puppet,modules/beta/manifests/saltmaster/tools.pp,1,1.0,1,0
wikimedia_puppet,modules/alternative/manifests/config.pp,1,1.0,1,0
wikimedia_puppet,modules/alternative/manifests/install.pp,1,1.0,1,0
wikimedia_puppet,modules/mediawiki/manifests/hhvm.pp,9,0.4339622641509434,3,6
wikimedia_puppet,modules/mediawiki/manifests/hhvm/params.pp,2,0.5,2,0
wikimedia_puppet,modules/mediawiki/manifests/jobrunner/hhvm.pp,1,1.0,1,0
wikimedia_puppet,modules/mediawiki/manifests/packages/hhvm.pp,2,0.5,2,0
wikimedia_puppet,modules/releases/manifests/reprepro.pp,6,0.3888888888888889,6,0
wikimedia_puppet,modules/reprepro/manifests/distribution.pp,2,0.5,2,0
wikimedia_puppet,modules/reprepro/manifests/init.pp,3,0.4,3,0
wikimedia_puppet,manifests/role/tor.pp,3,0.5,3,0
wikimedia_puppet,modules/tor/manifests/init.pp,5,0.3157894736842105,5,0
wikimedia_puppet,modules/zuul/manifests/user.pp,1,1.0,1,0
wikimedia_puppet,modules/apache/manifests/mpm.pp,5,0.5,5,0
wikimedia_puppet,modules/alternatives/manifests/config.pp,1,1.0,1,0
wikimedia_puppet,modules/alternatives/manifests/install.pp,2,0.5,2,0
wikimedia_puppet,modules/contint/manifests/qunit_localhost.pp,3,0.5,3,0
wikimedia_puppet,manifests/role/extdist.pp,2,0.6666666666666666,2,0
wikimedia_puppet,modules/extdist/manifests/init.pp,7,0.2857142857142857,7,0
wikimedia_puppet,modules/mediawiki/manifests/web/modules.pp,4,0.8235294117647058,4,0
wikimedia_puppet,manifests/role/labsquarry.pp,2,0.6666666666666666,2,0
wikimedia_puppet,modules/quarry/manifests/celeryrunner.pp,4,0.5714285714285714,4,0
wikimedia_puppet,modules/quarry/manifests/init.pp,7,0.38095238095238093,4,3
wikimedia_puppet,modules/quarry/manifests/web.pp,5,0.3,5,0
wikimedia_puppet,manifests/role/etherpad.pp,6,0.44,3,3
wikimedia_puppet,modules/etherpad/manifests/init.pp,2,0.8,2,0
wikimedia_puppet,manifests/role/mathoid.pp,6,0.5555555555555556,6,0
wikimedia_puppet,modules/mathoid/manifests/init.pp,7,0.45,7,0
wikimedia_puppet,modules/mathoid/tests/mathoid.pp,1,1.0,1,0
wikimedia_puppet,modules/mediawiki/manifests/web/envvars.pp,1,1.0,1,0
wikimedia_puppet,modules/hhvm/manifests/status.pp,2,0.5,2,0
wikimedia_puppet,manifests/role/transparency.pp,6,0.2857142857142857,6,0
wikimedia_puppet,modules/ocg/manifests/nagios/check.pp,2,0.8888888888888888,2,0
wikimedia_puppet,modules/ocg/manifests/nagios/plugin.pp,2,0.6666666666666666,2,0
wikimedia_puppet,modules/hhvm/manifests/admin.pp,4,0.5714285714285714,4,0
wikimedia_puppet,modules/hhvm/manifests/monitoring.pp,6,0.2857142857142857,6,0
wikimedia_puppet,modules/osm/manifests/planet_sync.pp,4,0.5217391304347826,4,0
wikimedia_puppet,modules/beta/manifests/puppetmaster/sync.pp,1,1.0,1,0
wikimedia_puppet,modules/apache/manifests/env.pp,3,0.3333333333333333,3,0
wikimedia_puppet,modules/alternatives/manifests/select.pp,1,1.0,1,0
wikimedia_puppet,modules/contint/manifests/website/labs.pp,3,0.4,3,0
wikimedia_puppet,modules/contint/manifests/proxy_gerrit.pp,2,0.5,2,0
wikimedia_puppet,manifests/role/labmon.pp,4,0.375,4,0
wikimedia_puppet,modules/wikistats/manifests/db.pp,5,0.5,5,0
wikimedia_puppet,manifests/role/trebuchet.pp,6,0.16666666666666666,6,0
wikimedia_puppet,modules/wikitech/manifests/wiki/passwords.pp,7,0.3333333333333333,7,0
wikimedia_puppet,modules/mediawiki/manifests/packages/php5.pp,4,0.36363636363636365,4,0
wikimedia_puppet,modules/mediawiki/manifests/packages/fonts.pp,9,0.23529411764705882,7,2
wikimedia_puppet,modules/mediawiki/manifests/packages/multimedia.pp,7,0.5294117647058824,7,0
wikimedia_puppet,modules/mediawiki/manifests/web/beta_sites.pp,9,0.2727272727272727,5,4
wikimedia_puppet,modules/phabricator/manifests/mailrelay.pp,4,0.4,4,0
wikimedia_puppet,modules/trebuchet/manifests/packages.pp,7,0.3333333333333333,7,0
wikimedia_puppet,modules/redis/manifests/client/python.pp,2,0.5,2,0
wikimedia_puppet,manifests/role/peopleweb.pp,2,0.8333333333333334,2,0
wikimedia_puppet,modules/publichtml/manifests/init.pp,5,0.375,5,0
wikimedia_puppet,manifests/role/servermon.pp,4,0.375,4,0
wikimedia_puppet,modules/servermon/manifests/init.pp,3,0.8125,3,0
wikimedia_puppet,modules/servermon/spec/fixtures/manifests/site.pp,2,0.5,2,0
wikimedia_puppet,modules/servermon/tests/init.pp,1,1.0,1,0
wikimedia_puppet,modules/phabricator/manifests/migration.pp,3,0.6666666666666666,3,0
wikimedia_puppet,modules/toollabs/manifests/monitoring.pp,3,0.6666666666666666,3,0
wikimedia_puppet,manifests/role/pybal_config.pp,3,0.4,3,0
wikimedia_puppet,modules/pybal/manifests/web.pp,2,0.7142857142857143,2,0
wikimedia_puppet,modules/mediawiki/manifests/scap.pp,10,0.2,10,0
wikimedia_puppet,modules/puppetmaster/manifests/hiera.pp,4,0.25,4,0
wikimedia_puppet,modules/lvs/manifests/interface-tweaks.pp,3,0.6,3,0
wikimedia_puppet,modules/contint/manifests/monitoring.pp,3,0.5,3,0
wikimedia_puppet,manifests/role/labsshinken.pp,2,0.6666666666666666,2,0
wikimedia_puppet,modules/shinken/manifests/server.pp,6,0.5,6,0
wikimedia_puppet,modules/beta/manifests/monitoring.pp,2,0.75,2,0
wikimedia_puppet,modules/nagios_common/manifests/user_macros.pp,3,0.3333333333333333,3,0
wikimedia_puppet,modules/nagios_common/manifests/check_command.pp,5,0.5,5,0
wikimedia_puppet,modules/nagios_common/manifests/commands.pp,15,0.2987012987012987,5,10
wikimedia_puppet,manifests/role/grafana.pp,13,0.26666666666666666,4,9
wikimedia_puppet,modules/grafana/manifests/init.pp,4,0.3333333333333333,4,0
wikimedia_puppet,modules/grafana/manifests/web/apache.pp,4,0.2857142857142857,4,0
wikimedia_puppet,modules/grafana/manifests/web/nginx.pp,1,1.0,1,0
wikimedia_puppet,manifests/role/url_downloader.pp,6,0.68,3,3
wikimedia_puppet,modules/url_downloader/manifests/init.pp,2,0.5,2,0
wikimedia_puppet,modules/url_downloader/spec/fixtures/manifests/site.pp,1,1.0,1,0
wikimedia_puppet,modules/url_downloader/tests/init.pp,1,1.0,1,0
wikimedia_puppet,manifests/role/ntp.pp,8,0.375,8,0
wikimedia_puppet,modules/ntp/manifests/daemon.pp,8,0.4,8,0
wikimedia_puppet,modules/nagios_common/manifests/timeperiods.pp,2,0.6666666666666666,2,0
wikimedia_puppet,modules/nagios_common/manifests/notification_commands.pp,4,0.5,4,0
wikimedia_puppet,modules/icinga/manifests/apache.pp,1,1.0,1,0
wikimedia_puppet,modules/icinga/manifests/logrotate.pp,1,1.0,1,0
wikimedia_puppet,modules/icinga/manifests/user.pp,1,1.0,1,0
wikimedia_puppet,modules/icinga/manifests/nsca/client.pp,3,0.3333333333333333,3,0
wikimedia_puppet,modules/icinga/manifests/nsca/daemon.pp,4,0.4,4,0
wikimedia_puppet,modules/icinga/manifests/nsca/firewall.pp,6,0.3,6,0
wikimedia_puppet,modules/icinga/manifests/monitor/wikidata.pp,4,0.36363636363636365,4,0
wikimedia_puppet,modules/icinga/manifests/monitor/checkpaging.pp,6,0.2222222222222222,6,0
wikimedia_puppet,modules/nagios_common/manifests/contacts.pp,10,0.18181818181818182,10,0
wikimedia_puppet,modules/dsh/manifests/config.pp,5,0.2,5,0
wikimedia_puppet,modules/dsh/manifests/init.pp,1,1.0,1,0
wikimedia_puppet,modules/icinga/manifests/packages.pp,1,1.0,1,0
wikimedia_puppet,modules/openldap/manifests/init.pp,3,0.5,3,0
wikimedia_puppet,modules/icinga/manifests/naggen.pp,7,0.25,7,0
wikimedia_puppet,modules/icinga/manifests/groups/misc.pp,4,0.4,4,0
wikimedia_puppet,modules/nagios_common/manifests/check/ganglia.pp,3,0.3333333333333333,3,0
wikimedia_puppet,modules/icinga/manifests/config.pp,1,1.0,1,0
wikimedia_puppet,modules/icinga/manifests/service.pp,1,1.0,1,0
wikimedia_puppet,modules/icinga/manifests/plugins.pp,11,0.3055555555555556,9,2
wikimedia_puppet,modules/icinga/manifests/init.pp,11,0.36,6,5
wikimedia_puppet,modules/icinga/manifests/web.pp,12,0.38461538461538464,8,4
wikimedia_puppet,manifests/role/icinga.pp,16,0.2894736842105263,10,6
wikimedia_puppet,modules/authdns/manifests/monitoring/global.pp,3,0.5,3,0
wikimedia_puppet,modules/swift_new/manifests/init.pp,2,0.8333333333333334,2,0
wikimedia_puppet,modules/swift_new/manifests/init_device.pp,3,0.6666666666666666,3,0
wikimedia_puppet,modules/swift_new/manifests/label_filesystem.pp,1,1.0,1,0
wikimedia_puppet,modules/swift_new/manifests/mount_filesystem.pp,1,1.0,1,0
wikimedia_puppet,modules/swift_new/manifests/params.pp,1,1.0,1,0
wikimedia_puppet,modules/swift_new/manifests/proxy.pp,1,1.0,1,0
wikimedia_puppet,modules/swift_new/manifests/ring.pp,1,1.0,1,0
wikimedia_puppet,modules/swift_new/manifests/stats/accounts.pp,1,1.0,1,0
wikimedia_puppet,modules/swift_new/manifests/stats/dispersion.pp,1,1.0,1,0
wikimedia_puppet,modules/swift_new/manifests/stats/stats_account.pp,1,1.0,1,0
wikimedia_puppet,modules/swift_new/manifests/storage.pp,1,1.0,1,0
wikimedia_puppet,modules/swift_new/manifests/storage/monitor_swift_daemon.pp,2,0.6666666666666666,2,0
wikimedia_puppet,modules/swift_new/manifests/storage/monitoring.pp,1,1.0,1,0
wikimedia_puppet,modules/hhvm/manifests/packages/dev.pp,1,1.0,1,0
wikimedia_puppet,manifests/role/openldap.pp,8,0.38095238095238093,4,4
wikimedia_puppet,modules/ocg/manifests/ganglia/module.pp,2,0.6666666666666666,2,0
wikimedia_puppet,modules/swift_new/manifests/monitoring/graphite.pp,3,0.6666666666666666,3,0
wikimedia_puppet,modules/phabricator/manifests/libext.pp,5,0.25,5,0
wikimedia_puppet,modules/dataset/manifests/cron/pagecounts_all_sites.pp,1,1.0,1,0
wikimedia_puppet,manifests/role/citoid.pp,4,0.4,4,0
wikimedia_puppet,modules/citoid/manifests/init.pp,6,0.4117647058823529,6,0
wikimedia_puppet,modules/citoid/tests/citoid.pp,1,1.0,1,0
wikimedia_puppet,modules/swift_new/manifests/container_sync.pp,2,0.75,2,0
wikimedia_puppet,modules/labs_lvm/manifests/extend.pp,4,0.25,4,0
wikimedia_puppet,modules/gridengine/manifests/resource.pp,3,0.8181818181818182,3,0
wikimedia_puppet,modules/gridengine/manifests/resourcedir.pp,5,0.6153846153846154,5,0
wikimedia_puppet,modules/toollabs/manifests/hostgroup.pp,1,1.0,1,0
wikimedia_puppet,modules/gridengine/manifests/hostgroup.pp,3,0.75,3,0
wikimedia_puppet,modules/gridengine/manifests/queue.pp,3,0.75,3,0
wikimedia_puppet,modules/toollabs/manifests/hostgroup/collector.pp,1,1.0,1,0
wikimedia_puppet,modules/toollabs/manifests/hostgroup/init.pp,1,1.0,1,0
wikimedia_puppet,modules/toollabs/manifests/queue/continuous.pp,2,0.6666666666666666,2,0
wikimedia_puppet,modules/toollabs/manifests/queue/task.pp,2,0.6666666666666666,2,0
wikimedia_puppet,modules/hhvm/manifests/packages.pp,2,0.6666666666666666,2,0
wikimedia_puppet,manifests/role/iegreview.pp,6,0.16666666666666666,6,0
wikimedia_puppet,modules/iegreview/manifests/init.pp,7,0.46153846153846156,7,0
wikimedia_puppet,manifests/role/apertium.pp,6,0.3888888888888889,6,0
wikimedia_puppet,modules/apertium/manifests/init.pp,8,0.53125,4,4
wikimedia_puppet,modules/apertium/tests/init.pp,1,1.0,1,0
wikimedia_puppet,manifests/role/requesttracker.pp,8,0.3157894736842105,8,0
wikimedia_puppet,modules/requesttracker/manifests/apache.pp,6,0.5,6,0
wikimedia_puppet,modules/requesttracker/manifests/config.pp,1,1.0,1,0
wikimedia_puppet,modules/requesttracker/manifests/forms.pp,1,1.0,1,0
wikimedia_puppet,modules/requesttracker/manifests/init.pp,2,0.75,2,0
wikimedia_puppet,modules/requesttracker/manifests/packages.pp,2,0.5,2,0
wikimedia_puppet,modules/requesttracker/manifests/plugins.pp,1,1.0,1,0
wikimedia_puppet,modules/graphite/manifests/labs-archiver.pp,1,1.0,1,0
wikimedia_puppet,modules/graphite/manifests/labs/archiver.pp,7,0.2727272727272727,7,0
wikimedia_puppet,modules/toollabs/manifests/compute.pp,6,0.5,6,0
wikimedia_puppet,modules/toollabs/manifests/node/compute/general.pp,4,0.4166666666666667,4,0
wikimedia_puppet,modules/toollabs/manifests/node/web.pp,4,0.5555555555555556,4,0
wikimedia_puppet,modules/toollabs/manifests/node/web/lighttpd.pp,3,0.4,3,0
wikimedia_puppet,modules/toollabs/manifests/node/web/tomcat.pp,2,0.6666666666666666,2,0
wikimedia_puppet,modules/motd/manifests/init.pp,2,0.8,2,0
wikimedia_puppet,modules/motd/manifests/script.pp,5,0.2,5,0
wikimedia_puppet,modules/racktables/manifests/init.pp,8,0.3076923076923077,8,0
wikimedia_puppet,modules/gerrit/manifests/crons.pp,3,0.782608695652174,2,1
wikimedia_puppet,modules/gerrit/manifests/instance.pp,2,0.5,2,0
wikimedia_puppet,modules/gerrit/manifests/jetty.pp,16,0.5803571428571429,3,13
wikimedia_puppet,modules/gerrit/manifests/proxy.pp,8,0.5,4,4
wikimedia_puppet,modules/gerrit/manifests/replicationdest.pp,4,0.4,4,0
wikimedia_puppet,modules/shinken/manifests/shinkengen.pp,10,0.29411764705882354,10,0
wikimedia_puppet,modules/gridengine/manifests/collector.pp,3,0.5,3,0
wikimedia_puppet,modules/gridengine/manifests/collectors/hostgroups.pp,1,1.0,1,0
wikimedia_puppet,modules/gridengine/manifests/join.pp,2,0.5,2,0
wikimedia_puppet,modules/toollabs/manifests/hostgroups.pp,2,0.6666666666666666,2,0
wikimedia_puppet,modules/gridengine/manifests/collectors/queues.pp,1,1.0,1,0
wikimedia_puppet,modules/toollabs/manifests/node/compute/dedicated.pp,4,0.4444444444444444,4,0
wikimedia_puppet,modules/toollabs/manifests/queues.pp,2,0.5,2,0
wikimedia_puppet,modules/openstack/manifests/adminscripts.pp,5,0.42857142857142855,4,1
wikimedia_puppet,modules/openstack/manifests/api-service.pp,1,1.0,1,0
wikimedia_puppet,modules/openstack/manifests/common.pp,5,0.38095238095238093,4,1
wikimedia_puppet,modules/openstack/manifests/compute-service.pp,1,1.0,1,0
wikimedia_puppet,modules/openstack/manifests/conductor-service.pp,1,1.0,1,0
wikimedia_puppet,modules/openstack/manifests/database-server.pp,4,0.6428571428571429,4,0
wikimedia_puppet,modules/openstack/manifests/firewall.pp,4,0.4,4,0
wikimedia_puppet,modules/openstack/manifests/glance-service.pp,1,1.0,1,0
wikimedia_puppet,modules/openstack/manifests/keystone-service.pp,1,1.0,1,0
wikimedia_puppet,modules/openstack/manifests/network-service.pp,1,1.0,1,0
wikimedia_puppet,modules/openstack/manifests/neutron-compute.pp,1,1.0,1,0
wikimedia_puppet,modules/openstack/manifests/neutron-controller.pp,1,1.0,1,0
wikimedia_puppet,modules/openstack/manifests/neutron-nethost.pp,1,1.0,1,0
wikimedia_puppet,modules/openstack/manifests/openstack-manager.pp,10,0.38461538461538464,5,5
wikimedia_puppet,modules/openstack/manifests/project-nfs-storage-service.pp,7,0.3333333333333333,7,0
wikimedia_puppet,modules/openstack/manifests/queue-server.pp,4,0.2857142857142857,4,0
wikimedia_puppet,modules/openstack/manifests/scheduler-service.pp,1,1.0,1,0
wikimedia_puppet,modules/openstack/manifests/volume-service.pp,1,1.0,1,0
wikimedia_puppet,modules/osm/manifests/ganglia.pp,3,0.5,3,0
wikimedia_puppet,modules/openstack/manifests/neutron/neutron-compute.pp,1,1.0,1,0
wikimedia_puppet,modules/openstack/manifests/neutron/neutron-controller.pp,1,1.0,1,0
wikimedia_puppet,modules/openstack/manifests/neutron/neutron-nethost.pp,1,1.0,1,0
wikimedia_puppet,modules/openstack/manifests/glance/glance-service.pp,1,1.0,1,0
wikimedia_puppet,modules/openstack/manifests/nova/api.pp,5,0.3333333333333333,5,0
wikimedia_puppet,modules/openstack/manifests/nova/compute.pp,14,0.29577464788732394,5,9
wikimedia_puppet,modules/openstack/manifests/nova/conductor.pp,5,0.3125,5,0
wikimedia_puppet,modules/openstack/manifests/nova/network.pp,9,0.35,6,3
wikimedia_puppet,modules/openstack/manifests/nova/scheduler.pp,5,0.29411764705882354,5,0
wikimedia_puppet,modules/openstack/manifests/nova/volume.pp,4,0.4,4,0
wikimedia_puppet,modules/openstack/manifests/glance/service.pp,11,0.3409090909090909,3,8
wikimedia_puppet,modules/openstack/manifests/neutron/compute.pp,2,0.6666666666666666,2,0
wikimedia_puppet,modules/openstack/manifests/neutron/controller.pp,3,0.3333333333333333,3,0
wikimedia_puppet,modules/openstack/manifests/neutron/nethost.pp,3,0.5,3,0
wikimedia_puppet,modules/openstack/manifests/keystone/service.pp,10,0.3142857142857143,5,5
wikimedia_puppet,modules/gridengine/manifests/admin_host.pp,3,0.3333333333333333,3,0
wikimedia_puppet,modules/sudo/manifests/group.pp,2,0.8333333333333334,2,0
wikimedia_puppet,modules/sudo/manifests/init.pp,4,0.5,4,0
wikimedia_puppet,modules/sudo/manifests/labs_project.pp,2,0.6666666666666666,2,0
wikimedia_puppet,modules/sudo/manifests/user.pp,3,0.7142857142857143,3,0
wikimedia_puppet,manifests/role/bastionhost.pp,4,0.3333333333333333,4,0
wikimedia_puppet,modules/contint/manifests/browsers.pp,7,0.2,7,0
wikimedia_puppet,modules/xvfb/manifests/init.pp,2,0.8,2,0
wikimedia_puppet,manifests/role/noc.pp,1,1.0,1,0
wikimedia_puppet,modules/noc/manifests/init.pp,6,0.4090909090909091,4,2
wikimedia_puppet,modules/webserver/init.pp,1,1.0,1,0
wikimedia_puppet,modules/webserver/manifests/apache.pp,1,1.0,1,0
wikimedia_puppet,modules/webserver/manifests/apache/site.pp,5,0.3333333333333333,5,0
wikimedia_puppet,modules/webserver/manifests/php5.pp,2,0.6666666666666666,2,0
wikimedia_puppet,modules/webserver/manifests/static.pp,3,0.5,3,0
wikimedia_puppet,modules/webserver/manifests/sysctl_settings.pp,1,1.0,1,0
wikimedia_puppet,modules/webserver/sysctl_settings.pp,1,1.0,1,0
wikimedia_puppet,manifests/role/ipmi.pp,1,1.0,1,0
wikimedia_puppet,modules/ipmi/manifests/init.pp,3,0.3333333333333333,3,0
wikimedia_puppet,manifests/role/contacts.pp,2,0.75,2,0
wikimedia_puppet,modules/contacts/manifests/init.pp,2,0.5,2,0
wikimedia_puppet,manifests/role/rancid.pp,1,1.0,1,0
wikimedia_puppet,modules/rancid/manifests/init.pp,7,0.3,7,0
wikimedia_puppet,modules/phabricator/manifests/phd.pp,6,0.4117647058823529,6,0
wikimedia_puppet,modules/phabricator/manifests/monitoring.pp,8,0.3684210526315789,8,0
wikimedia_puppet,modules/requesttracker/manifests/aliases.pp,3,0.4,3,0
wikimedia_puppet,modules/osm/manifests/init.pp,5,0.3,5,0
wikimedia_puppet,modules/backup/manifests/mysqlset.pp,4,0.4,4,0
wikimedia_puppet,modules/backup/manifests/schedule.pp,2,0.6666666666666666,2,0
wikimedia_puppet,modules/backup/manifests/set.pp,4,0.7,4,0
wikimedia_puppet,modules/backup/manifests/weeklyschedule.pp,2,0.5,2,0
wikimedia_puppet,modules/backup/spec/fixtures/manifests/site.pp,1,1.0,1,0
wikimedia_puppet,manifests/role/postgres.pp,3,0.7,3,0
wikimedia_puppet,modules/shinken/manifests/hosts.pp,1,1.0,1,0
wikimedia_puppet,modules/phabricator/manifests/extension.pp,6,0.2222222222222222,6,0
wikimedia_puppet,modules/phabricator/manifests/redirector.pp,6,0.4,6,0
wikimedia_puppet,modules/monitoring/manifests/graphite_threshold.pp,8,0.25,8,0
wikimedia_puppet,modules/monitoring/manifests/graphite_anomaly.pp,7,0.3076923076923077,7,0
wikimedia_puppet,modules/monitoring/manifests/ganglia.pp,3,0.5,3,0
wikimedia_puppet,modules/icinga/manifests/group.pp,1,1.0,1,0
wikimedia_puppet,modules/icinga/manifests/gsbmonitoring.pp,4,0.4,4,0
wikimedia_puppet,modules/contint/manifests/monitoring/graphite.pp,3,0.3333333333333333,3,0
wikimedia_puppet,modules/hhvm/manifests/debug.pp,5,0.42857142857142855,5,0
wikimedia_puppet,modules/mysql/manifests/server/package.pp,3,0.6,3,0
wikimedia_puppet,modules/mysql/manifests/config/client.pp,2,0.5,2,0
wikimedia_puppet,modules/mysql/manifests/config/file.pp,1,1.0,1,0
wikimedia_puppet,modules/beta/manifests/monitoring/graphite.pp,1,1.0,1,0
wikimedia_puppet,modules/beta/manifests/monitoring/shinken.pp,2,0.6666666666666666,2,0
wikimedia_puppet,modules/monitoring/manifests/decommission_host.pp,1,1.0,1,0
wikimedia_puppet,modules/monitoring/manifests/group.pp,4,0.3333333333333333,4,0
wikimedia_puppet,modules/java/manifests/tools.pp,5,0.3333333333333333,5,0
wikimedia_puppet,manifests/defaults.pp,2,0.75,2,0
wikimedia_puppet,manifests/role/ganglia.pp,9,0.3076923076923077,6,3
wikimedia_puppet,modules/ganglia_new/manifests/gmetad.pp,2,0.6666666666666666,2,0
wikimedia_puppet,modules/ganglia_new/manifests/gmetad/rrdcached.pp,2,0.6666666666666666,2,0
wikimedia_puppet,modules/ganglia_new/manifests/web.pp,6,0.5714285714285714,6,0
wikimedia_puppet,modules/ganglia_new/tests/gmetad.pp,2,0.5,2,0
wikimedia_puppet,modules/ganglia_new/tests/rrdcached.pp,1,1.0,1,0
wikimedia_puppet,modules/ganglia_new/tests/web.pp,1,1.0,1,0
wikimedia_puppet,modules/shinken/manifests/services.pp,1,1.0,1,0
wikimedia_puppet,modules/keyholder/manifests/init.pp,10,0.15789473684210525,10,0
wikimedia_puppet,modules/mysql_wmf/manifests/client.pp,1,1.0,1,0
wikimedia_puppet,modules/mysql_wmf/manifests/datadirs.pp,1,1.0,1,0
wikimedia_puppet,modules/mysql_wmf/manifests/mysqlpath.pp,1,1.0,1,0
wikimedia_puppet,modules/mysql_wmf/manifests/mysqluser.pp,2,0.5,2,0
wikimedia_puppet,modules/mysql_wmf/manifests/pc/conf.pp,1,1.0,1,0
wikimedia_puppet,modules/mysql_wmf/manifests/slow_digest.pp,1,1.0,1,0
wikimedia_puppet,modules/icinga/manifests/ircbot.pp,13,0.17647058823529413,13,0
wikimedia_puppet,modules/monitoring/manifests/host.pp,10,0.49122807017543857,4,6
wikimedia_puppet,modules/restbase/manifests/init.pp,14,0.2978723404255319,5,9
wikimedia_puppet,modules/keyholder/manifests/private_key.pp,2,0.6666666666666666,2,0
wikimedia_puppet,modules/keyholder/manifests/monitoring.pp,4,0.25,4,0
wikimedia_puppet,modules/monitoring/manifests/service.pp,11,0.35135135135135137,5,6
wikimedia_puppet,modules/memcached/manifests/monitoring.pp,2,0.5,2,0
wikimedia_puppet,modules/monitoring/manifests/configuration.pp,1,1.0,1,0
wikimedia_puppet,manifests/role/restbase.pp,8,0.5357142857142857,4,4
wikimedia_puppet,modules/base/manifests/phaste.pp,2,0.5,2,0
wikimedia_puppet,manifests/role/cassandra.pp,10,0.46153846153846156,3,7
wikimedia_puppet,manifests/role/torrus.pp,6,0.46153846153846156,6,0
wikimedia_puppet,modules/torrus/manifests/config.pp,1,1.0,1,0
wikimedia_puppet,modules/torrus/manifests/discovery.pp,2,0.5,2,0
wikimedia_puppet,modules/torrus/manifests/discovery/ddxfile.pp,1,1.0,1,0
wikimedia_puppet,modules/torrus/manifests/init.pp,2,0.5,2,0
wikimedia_puppet,modules/torrus/manifests/web.pp,3,0.3333333333333333,3,0
wikimedia_puppet,modules/torrus/manifests/xml_generation/cdn.pp,3,0.3333333333333333,3,0
wikimedia_puppet,modules/torrus/manifests/xmlconfig.pp,2,0.5,2,0
wikimedia_puppet,modules/torrus/tests/cdn.pp,9,0.2777777777777778,9,0
wikimedia_puppet,modules/torrus/tests/config.pp,2,0.5,2,0
wikimedia_puppet,modules/torrus/tests/ddxfile.pp,1,1.0,1,0
wikimedia_puppet,modules/torrus/tests/discovery.pp,2,0.5,2,0
wikimedia_puppet,modules/torrus/tests/init.pp,2,0.5,2,0
wikimedia_puppet,modules/torrus/tests/web.pp,2,0.5,2,0
wikimedia_puppet,modules/torrus/tests/xmlconfig.pp,2,0.5,2,0
wikimedia_puppet,manifests/role/ircyall.pp,1,1.0,1,0
wikimedia_puppet,modules/ircyall/manifests/init.pp,5,0.42857142857142855,5,0
wikimedia_puppet,modules/openstack/manifests/init.pp,2,0.6666666666666666,2,0
wikimedia_puppet,modules/mediawiki/manifests/hhvm/housekeeping.pp,1,1.0,1,0
wikimedia_puppet,modules/ocg/manifests/ganglia.pp,1,1.0,1,0
wikimedia_puppet,modules/ocg/manifests/nagios.pp,3,0.3333333333333333,3,0
wikimedia_puppet,modules/deployment/manifests/scap_proxy.pp,1,1.0,1,0
wikimedia_puppet,modules/puppetmaster/manifests/gitsync.pp,5,0.46153846153846156,5,0
wikimedia_puppet,modules/shinken/manifests/init.pp,5,0.3333333333333333,5,0
wikimedia_puppet,modules/shinken/manifests/ircbot.pp,10,0.25,10,0
wikimedia_puppet,modules/shinken/manifests/config.pp,2,0.5,2,0
wikimedia_puppet,modules/facilities/manifests/init.pp,4,0.5714285714285714,4,0
wikimedia_puppet,modules/facilities/manifests/monitor_pdu_3phase.pp,2,0.8,2,0
wikimedia_puppet,modules/facilities/manifests/monitor_pdu_service.pp,4,0.42857142857142855,4,0
wikimedia_puppet,modules/ganglia_new/manifests/web/view.pp,1,1.0,1,0
wikimedia_puppet,modules/ganglia_new/tests/view.pp,1,1.0,1,0
wikimedia_puppet,modules/logstash/manifests/input/tcp.pp,3,0.3333333333333333,3,0
wikimedia_puppet,modules/puppetmaster/manifests/reporter/logstash.pp,1,1.0,1,0
wikimedia_puppet,modules/webperf/manifests/statsv.pp,7,0.3333333333333333,7,0
wikimedia_puppet,manifests/role/labswdq-mm.pp,2,0.5,2,0
wikimedia_puppet,modules/wdq-mm/manifests/init.pp,3,0.6,3,0
wikimedia_puppet,modules/wdq-mm/manifests/lb.pp,1,1.0,1,0
wikimedia_puppet,modules/mediawiki/manifests/web/mpm_config.pp,3,0.7142857142857143,3,0
wikimedia_puppet,manifests/role/analytics/mahout.pp,1,1.0,1,0
wikimedia_puppet,modules/squid3/manifests/init.pp,4,0.4,4,0
wikimedia_puppet,modules/monitoring/manifests/decommission_monitor_host.pp,2,0.5,2,0
wikimedia_puppet,manifests/role/xenon.pp,6,0.3333333333333333,6,0
wikimedia_puppet,modules/xenon/manifests/init.pp,7,0.2727272727272727,7,0
wikimedia_puppet,modules/phabricator/manifests/logmail.pp,8,0.3,8,0
wikimedia_puppet,modules/squid3/spec/fixtures/manifests/site.pp,2,0.5,2,0
wikimedia_puppet,modules/squid3/tests/init.pp,1,1.0,1,0
wikimedia_puppet,modules/labs_bootstrapvz/manifests/init.pp,8,0.4,2,6
wikimedia_puppet,modules/openstack/manifests/nova/partition.pp,3,0.7777777777777778,3,0
wikimedia_puppet,modules/toollabs/manifests/static.pp,9,0.4,9,0
wikimedia_puppet,modules/toollabs/manifests/node/web/uwsgi.pp,4,0.3333333333333333,4,0
wikimedia_puppet,manifests/role/abacist.pp,4,0.5,4,0
wikimedia_puppet,modules/abacist/manifests/init.pp,2,0.5,2,0
wikimedia_puppet,modules/motd/manifests/defaults.pp,2,0.5,2,0
wikimedia_puppet,modules/mirrors/manifests/init.pp,2,0.75,2,0
wikimedia_puppet,modules/mirrors/manifests/ubuntu.pp,2,0.8,2,0
wikimedia_puppet,modules/mirrors/manifests/debian.pp,2,0.9166666666666666,2,0
wikimedia_puppet,modules/mirrors/manifests/serve.pp,4,0.42857142857142855,4,0
wikimedia_puppet,modules/mirrors/spec/fixtures/manifests/site.pp,2,0.6666666666666666,2,0
wikimedia_puppet,modules/maven/init.pp,1,1.0,1,0
wikimedia_puppet,modules/maven/manifests/init.pp,1,1.0,1,0
wikimedia_puppet,modules/contint/manifests/hhvm.pp,5,0.3333333333333333,5,0
wikimedia_puppet,modules/bugzilla/manifests/static.pp,2,0.6666666666666666,2,0
wikimedia_puppet,modules/locales/manifests/extended.pp,2,0.6666666666666666,2,0
wikimedia_puppet,modules/locales/manifests/init.pp,1,1.0,1,0
wikimedia_puppet,modules/locales/manifests/all.pp,2,0.6666666666666666,2,0
wikimedia_puppet,modules/debconf/manifests/set.pp,1,1.0,1,0
wikimedia_puppet,modules/dataset/manifests/common.pp,2,0.6666666666666666,2,0
wikimedia_puppet,manifests/role/dumps.pp,5,0.7222222222222222,5,0
wikimedia_puppet,modules/dumps/manifests/init.pp,10,0.3333333333333333,6,4
wikimedia_puppet,manifests/role/annualreport.pp,2,0.5,2,0
wikimedia_puppet,modules/annualreport/manifests/init.pp,5,0.375,5,0
wikimedia_puppet,modules/mailman/manifests/init.pp,2,0.6666666666666666,2,0
wikimedia_puppet,modules/mailman/manifests/listserve.pp,4,0.625,4,0
wikimedia_puppet,modules/mailman/manifests/webui.pp,8,0.38461538461538464,8,0
wikimedia_puppet,modules/statistics/manifests/aggregator.pp,3,0.5,3,0
wikimedia_puppet,modules/statistics/manifests/compute.pp,8,0.35294117647058826,4,4
wikimedia_puppet,modules/statistics/manifests/dataset_mount.pp,4,0.5,4,0
wikimedia_puppet,modules/statistics/manifests/init.pp,5,0.2857142857142857,5,0
wikimedia_puppet,modules/statistics/manifests/password.pp,1,1.0,1,0
wikimedia_puppet,modules/statistics/manifests/rsync/eventlogging.pp,5,0.4,5,0
wikimedia_puppet,modules/statistics/manifests/rsync/webrequest.pp,2,0.8333333333333334,2,0
wikimedia_puppet,modules/statistics/manifests/rsync_job.pp,5,0.5,5,0
wikimedia_puppet,modules/statistics/manifests/rsyncd.pp,8,0.2222222222222222,8,0
wikimedia_puppet,modules/statistics/manifests/sites/datasets.pp,4,0.5,4,0
wikimedia_puppet,modules/statistics/manifests/sites/metrics.pp,4,0.5,4,0
wikimedia_puppet,modules/statistics/manifests/sites/reportcard.pp,1,1.0,1,0
wikimedia_puppet,modules/statistics/manifests/sites/stats.pp,8,0.2857142857142857,5,3
wikimedia_puppet,modules/statistics/manifests/user.pp,5,0.3333333333333333,5,0
wikimedia_puppet,modules/statistics/manifests/web.pp,6,0.2,6,0
wikimedia_puppet,modules/statistics/manifests/wikistats.pp,1,1.0,1,0
wikimedia_puppet,modules/statistics/manifests/limn/data.pp,2,0.5,2,0
wikimedia_puppet,modules/statistics/manifests/limn/data/generate.pp,1,1.0,1,0
wikimedia_puppet,modules/statistics/manifests/cron_blog_pageviews.pp,1,1.0,1,0
wikimedia_puppet,manifests/role/sca.pp,5,0.5,5,0
wikimedia_puppet,modules/chromium/manifests/init.pp,3,0.4,3,0
wikimedia_puppet,manifests/role/ve.pp,7,0.5882352941176471,7,0
wikimedia_puppet,modules/scap/manifests/scripts.pp,10,0.18181818181818182,6,4
wikimedia_puppet,modules/scap/manifests/master.pp,14,0.25,7,7
wikimedia_puppet,manifests/role/scap.pp,1,1.0,1,0
wikimedia_puppet,modules/scap/manifests/l10nupdate.pp,16,0.21428571428571427,6,10
wikimedia_puppet,modules/scap/manifests/proxy.pp,3,0.5,3,0
wikimedia_puppet,manifests/role/devportal.pp,2,0.5,2,0
wikimedia_puppet,modules/devportal/manifests/init.pp,1,1.0,1,0
wikimedia_puppet,modules/geowiki/manifests/init.pp,2,0.75,2,0
wikimedia_puppet,modules/geowiki/manifests/job.pp,4,0.4,4,0
wikimedia_puppet,modules/geowiki/manifests/job/data.pp,2,0.75,2,0
wikimedia_puppet,modules/geowiki/manifests/job/limn.pp,4,0.6666666666666666,4,0
wikimedia_puppet,modules/geowiki/manifests/job/monitoring.pp,3,0.42857142857142855,3,0
wikimedia_puppet,modules/geowiki/manifests/mysql_conf.pp,3,0.5,3,0
wikimedia_puppet,modules/geowiki/manifests/params.pp,1,1.0,1,0
wikimedia_puppet,modules/geowiki/manifests/private_data.pp,4,0.4444444444444444,4,0
wikimedia_puppet,modules/base/manifests/grub.pp,6,0.4166666666666667,6,0
wikimedia_puppet,modules/base/manifests/screenconfig.pp,1,1.0,1,0
wikimedia_puppet,modules/base/manifests/firewall.pp,9,0.23076923076923078,9,0
wikimedia_puppet,modules/base/manifests/remote-syslog.pp,1,1.0,1,0
wikimedia_puppet,modules/base/manifests/syslogs.pp,3,0.5,3,0
wikimedia_puppet,modules/toollabs/manifests/node/web/generic.pp,2,0.8571428571428571,2,0
wikimedia_puppet,modules/dataset/manifests/html.pp,5,0.5,5,0
wikimedia_puppet,modules/dataset/manifests/dirs.pp,7,0.3333333333333333,7,0
wikimedia_puppet,modules/base/manifests/service_unit.pp,11,0.32,4,7
wikimedia_puppet,modules/base/spec/fixtures/manifests/site.pp,1,1.0,1,0
wikimedia_puppet,manifests/role/analytics/spark.pp,3,0.3333333333333333,3,0
wikimedia_puppet,manifests/metrics.pp,1,1.0,1,0
wikimedia_puppet,modules/mediawiki/manifests/php_enmod.pp,4,0.25,4,0
wikimedia_puppet,manifests/role/zotero.pp,4,0.25,4,0
wikimedia_puppet,modules/dataset/manifests/cron/mediacounts.pp,1,1.0,1,0
wikimedia_puppet,modules/statsdlb/manifests/init.pp,2,0.75,2,0
wikimedia_puppet,manifests/role/statsdlb.pp,6,0.4166666666666667,6,0
wikimedia_puppet,manifests/role/ipsec.pp,9,0.2916666666666667,6,3
wikimedia_puppet,modules/strongswan/manifests/init.pp,7,0.3333333333333333,7,0
wikimedia_puppet,modules/toollabs/manifests/toolwatcher.pp,2,0.75,2,0
wikimedia_puppet,modules/apache/manifests/helper_scripts.pp,1,1.0,1,0
wikimedia_puppet,manifests/role/horizon.pp,6,0.3,6,0
wikimedia_puppet,modules/openstack/manifests/horizon/service.pp,8,0.41379310344827586,3,5
wikimedia_puppet,modules/base/manifests/instance-upstarts.pp,1,1.0,1,0
wikimedia_puppet,manifests/role/labslvm.pp,3,0.3333333333333333,3,0
wikimedia_puppet,modules/zotero/manifests/init.pp,4,0.5,4,0
wikimedia_puppet,modules/zotero/tests/zotero.pp,1,1.0,1,0
wikimedia_puppet,modules/ssh/manifests/userkey.pp,5,0.375,5,0
wikimedia_puppet,modules/beta/manifests/deployaccess.pp,8,0.2222222222222222,8,0
wikimedia_puppet,modules/openstack/manifests/replica_management_service.pp,2,0.5,2,0
wikimedia_puppet,modules/puppetmaster/manifests/autosigner.pp,3,0.3333333333333333,3,0
wikimedia_puppet,modules/dnsrecursor/manifests/init.pp,9,0.2777777777777778,9,0
wikimedia_puppet,modules/dnsrecursor/manifests/metrics.pp,2,0.5,2,0
wikimedia_puppet,modules/dnsrecursor/manifests/monitor.pp,2,0.6666666666666666,2,0
wikimedia_puppet,modules/labs_ldap_dns/manifests/init.pp,2,0.5,2,0
wikimedia_puppet,manifests/role/designate.pp,6,0.42105263157894735,6,0
wikimedia_puppet,modules/openstack/manifests/designate/service.pp,7,0.42,4,3
wikimedia_puppet,manifests/role/labsdns.pp,8,0.43333333333333335,6,2
wikimedia_puppet,modules/labs_dns/manifests/init.pp,3,0.4444444444444444,3,0
wikimedia_puppet,modules/sslcert/manifests/init.pp,3,0.42857142857142855,3,0
wikimedia_puppet,modules/sslcert/manifests/ca.pp,3,0.5,3,0
wikimedia_puppet,modules/sslcert/manifests/certificate.pp,5,0.47058823529411764,5,0
wikimedia_puppet,modules/sslcert/manifests/chainedcert.pp,5,0.5714285714285714,5,0
wikimedia_puppet,modules/graphite/manifests/monitoring/graphite.pp,5,0.4,5,0
wikimedia_puppet,modules/protoproxy/manifests/ocsp_updater.pp,3,0.3333333333333333,3,0
wikimedia_puppet,manifests/role/jsbench.pp,4,0.5714285714285714,4,0
wikimedia_puppet,modules/strongswan/manifests/monitoring/host.pp,5,0.3333333333333333,5,0
wikimedia_puppet,manifests/role/ganeti.pp,5,0.6470588235294118,5,0
wikimedia_puppet,modules/ganeti/manifests/init.pp,4,0.3333333333333333,4,0
wikimedia_puppet,modules/ganeti/manifests/kvm.pp,3,0.5,3,0
wikimedia_puppet,modules/ganeti/tests/ganeti.pp,1,1.0,1,0
wikimedia_puppet,modules/diamond/manifests/collector/conntrack.pp,1,1.0,1,0
wikimedia_puppet,modules/dumps/manifests/zim.pp,4,0.4,4,0
wikimedia_puppet,modules/snapshot/manifests/wikidatadumps.pp,5,0.5,5,0
wikimedia_puppet,modules/webperf/manifests/rrd_navtiming.pp,1,1.0,1,0
wikimedia_puppet,modules/archiva/manifests/proxy.pp,10,0.2222222222222222,10,0
wikimedia_puppet,modules/toollabs/manifests/services.pp,4,0.5555555555555556,4,0
wikimedia_puppet,modules/statsite/manifests/init.pp,4,0.5714285714285714,4,0
wikimedia_puppet,modules/statsite/manifests/instance.pp,3,0.8333333333333334,3,0
wikimedia_puppet,manifests/role/statsite.pp,2,0.5,2,0
wikimedia_puppet,modules/package_builder/manifests/environments.pp,1,1.0,1,0
wikimedia_puppet,modules/package_builder/manifests/hooks.pp,2,0.8333333333333334,2,0
wikimedia_puppet,modules/package_builder/manifests/init.pp,14,0.2857142857142857,4,10
wikimedia_puppet,modules/package_builder/manifests/pbuilder_base.pp,1,1.0,1,0
wikimedia_puppet,modules/package_builder/manifests/pbuilder_hook.pp,5,0.4,5,0
wikimedia_puppet,modules/package_builder/tests/init.pp,2,0.5,2,0
wikimedia_puppet,manifests/role/analytics/packages.pp,1,1.0,1,0
wikimedia_puppet,modules/wikidatabuilder/manifests/init.pp,4,0.25,4,0
wikimedia_puppet,manifests/role/brrd.pp,1,1.0,1,0
wikimedia_puppet,modules/brrd/manifests/init.pp,1,1.0,1,0
wikimedia_puppet,modules/role/manifests/cache/2layer.pp,5,0.6296296296296297,4,1
wikimedia_puppet,modules/service/manifests/configuration.pp,4,0.6,4,0
wikimedia_puppet,modules/service/manifests/node.pp,15,0.3684210526315789,5,10
wikimedia_puppet,modules/role/manifests/cache/1layer.pp,1,1.0,1,0
wikimedia_puppet,modules/role/manifests/cache/base.pp,10,0.4117647058823529,4,6
wikimedia_puppet,modules/role/manifests/cache/bits.pp,5,0.5,5,0
wikimedia_puppet,modules/role/manifests/cache/configuration.pp,5,0.4827586206896552,4,1
wikimedia_puppet,modules/role/manifests/cache/kafka.pp,5,0.3333333333333333,5,0
wikimedia_puppet,modules/role/manifests/cache/kafka/eventlogging.pp,9,0.2631578947368421,9,0
wikimedia_puppet,modules/role/manifests/cache/kafka/statsv.pp,11,0.21739130434782608,8,3
wikimedia_puppet,modules/role/manifests/cache/kafka/webrequest.pp,15,0.2391304347826087,4,11
wikimedia_puppet,modules/role/manifests/cache/logging.pp,5,0.2,5,0
wikimedia_puppet,modules/role/manifests/cache/logging/eventlistener.pp,4,0.3333333333333333,4,0
wikimedia_puppet,modules/role/manifests/cache/misc.pp,21,0.2727272727272727,6,15
wikimedia_puppet,modules/role/manifests/cache/mobile.pp,9,0.4444444444444444,3,6
wikimedia_puppet,modules/role/manifests/cache/parsoid.pp,9,0.45454545454545453,4,5
wikimedia_puppet,modules/role/manifests/cache/ssl/local.pp,1,1.0,1,0
wikimedia_puppet,modules/role/manifests/cache/ssl/misc.pp,3,0.6875,3,0
wikimedia_puppet,modules/role/manifests/cache/ssl/parsoid.pp,1,1.0,1,0
wikimedia_puppet,modules/role/manifests/cache/ssl/sni.pp,2,0.6666666666666666,2,0
wikimedia_puppet,modules/role/manifests/cache/statsd.pp,5,0.6,5,0
wikimedia_puppet,modules/role/manifests/cache/text.pp,16,0.352112676056338,5,11
wikimedia_puppet,modules/role/manifests/cache/upload.pp,13,0.40425531914893614,3,10
wikimedia_puppet,modules/puppetmaster/manifests/certmanager.pp,5,0.375,5,0
wikimedia_puppet,modules/role/manifests/cache/perf.pp,5,0.8181818181818182,1,4
wikimedia_puppet,modules/webperf/manifests/coal.pp,1,1.0,1,0
wikimedia_puppet,modules/package_builder/tests/environments.pp,2,0.5,2,0
wikimedia_puppet,modules/package_builder/tests/hooks.pp,2,0.5,2,0
wikimedia_puppet,modules/package_builder/tests/pbuilder_base.pp,1,1.0,1,0
wikimedia_puppet,modules/package_builder/tests/pbuilder_hook.pp,1,1.0,1,0
wikimedia_puppet,manifests/role/coal.pp,1,1.0,1,0
wikimedia_puppet,modules/coal/manifests/init.pp,8,0.2857142857142857,8,0
wikimedia_puppet,modules/citoid/tests/init.pp,1,1.0,1,0
wikimedia_puppet,manifests/role/analytics/impala.pp,4,0.5454545454545454,4,0
wikimedia_puppet,modules/graphite/manifests/carbon_c_relay.pp,4,0.5,4,0
wikimedia_puppet,manifests/role/graphoid.pp,3,0.5,3,0
wikimedia_puppet,modules/graphoid/manifests/init.pp,7,0.35714285714285715,7,0
wikimedia_puppet,modules/sysfs/manifests/conffile.pp,2,0.5,2,0
wikimedia_puppet,modules/sysfs/manifests/init.pp,2,0.6666666666666666,2,0
wikimedia_puppet,modules/sysfs/manifests/parameters.pp,2,0.5,2,0
wikimedia_puppet,modules/diamond/manifests/collector/extendedexim.pp,3,0.4,3,0
wikimedia_puppet,modules/diamond/manifests/collector/localcrontab.pp,4,0.4,4,0
wikimedia_puppet,manifests/role/policysite.pp,2,0.5,2,0
wikimedia_puppet,modules/policysite/manifests/init.pp,1,1.0,1,0
wikimedia_puppet,modules/labs_lvm/manifests/swap.pp,2,0.5,2,0
wikimedia_puppet,modules/toollabs/manifests/checker.pp,7,0.3142857142857143,5,2
wikimedia_puppet,modules/icinga/manifests/monitor/ripeatlas.pp,3,0.42857142857142855,3,0
wikimedia_puppet,manifests/role/zookeeper.pp,6,0.3076923076923077,6,0
wikimedia_puppet,modules/statsite/manifests/decommission.pp,1,1.0,1,0
wikimedia_puppet,manifests/role/labsmesos.pp,1,1.0,1,0
wikimedia_puppet,modules/mesos/manifests/master.pp,1,1.0,1,0
wikimedia_puppet,modules/mesos/manifests/slave.pp,2,0.5,2,0
wikimedia_puppet,manifests/role/ceilometer.pp,2,0.6666666666666666,2,0
wikimedia_puppet,modules/openstack/manifests/ceilometer/compute.pp,4,0.375,4,0
wikimedia_puppet,modules/openstack/manifests/ceilometer/controller.pp,4,0.375,4,0
wikimedia_puppet,modules/base/manifests/remote_syslog.pp,4,0.6,4,0
wikimedia_puppet,modules/nrpe/manifests/monitor_systemd_unit.pp,2,0.5,2,0
wikimedia_puppet,modules/nrpe/manifests/systemd_scripts.pp,5,0.3,5,0
wikimedia_puppet,modules/statistics/manifests/rsync/mediawiki.pp,8,0.29411764705882354,8,0
wikimedia_puppet,manifests/role/etcd.pp,3,0.8181818181818182,3,0
wikimedia_puppet,modules/etcd/manifests/init.pp,3,0.7333333333333333,3,0
wikimedia_puppet,modules/etcd/manifests/logging.pp,2,0.75,2,0
wikimedia_puppet,modules/etcd/manifests/monitoring.pp,4,0.5,4,0
wikimedia_puppet,modules/etcd/manifests/ssl.pp,3,0.6666666666666666,3,0
wikimedia_puppet,modules/puppetmaster/manifests/logstash.pp,1,1.0,1,0
wikimedia_puppet,modules/base/manifests/puppet/config.pp,1,1.0,1,0
wikimedia_puppet,modules/mailman/manifests/scripts.pp,2,0.7272727272727273,2,0
wikimedia_puppet,modules/mesos/manifests/marathon/config.pp,1,1.0,1,0
wikimedia_puppet,modules/mesos/manifests/marathon/master.pp,1,1.0,1,0
wikimedia_puppet,modules/mesos/manifests/proxy.pp,1,1.0,1,0
wikimedia_puppet,manifests/role/labsores.pp,3,0.5357142857142857,2,1
wikimedia_puppet,modules/ores/manifests/web.pp,11,0.4918032786885246,4,7
wikimedia_puppet,modules/ores/manifests/lb.pp,2,0.6666666666666666,2,0
wikimedia_puppet,modules/puppetmaster/manifests/generators.pp,4,0.42857142857142855,4,0
wikimedia_puppet,modules/diamond/manifests/collector_module.pp,2,0.5,2,0
wikimedia_puppet,modules/confd/manifests/file.pp,2,0.8333333333333334,2,0
wikimedia_puppet,modules/confd/manifests/init.pp,6,0.4666666666666667,6,0
wikimedia_puppet,modules/varnish/manifests/logging/statsd.pp,6,0.5625,6,0
wikimedia_puppet,modules/base/manifests/certificates.pp,7,0.375,7,0
wikimedia_puppet,modules/diamond/manifests/collector/custom.pp,1,1.0,1,0
wikimedia_puppet,modules/openstack/manifests/controller_firewall.pp,4,0.5,4,0
wikimedia_puppet,modules/openstack/manifests/spreadcheck.pp,3,0.5,3,0
wikimedia_puppet,modules/varnish/manifests/monitoring/varnishreqstats.pp,4,0.42857142857142855,4,0
wikimedia_puppet,modules/ores/manifests/redis.pp,7,0.3157894736842105,7,0
wikimedia_puppet,modules/ores/manifests/redisproxy.pp,1,1.0,1,0
wikimedia_puppet,modules/tmpreaper/manifests/dir.pp,1,1.0,1,0
wikimedia_puppet,modules/tmpreaper/manifests/init.pp,1,1.0,1,0
wikimedia_puppet,modules/tmpreaper/manifests/reap.pp,2,0.5,2,0
wikimedia_puppet,modules/phabricator/manifests/vcs.pp,9,0.4,6,3
wikimedia_puppet,modules/conftool/manifests/init.pp,2,0.6428571428571429,2,0
wikimedia_puppet,modules/pybal/manifests/confd.pp,3,0.5,3,0
wikimedia_puppet,modules/role/manifests/lvs/balancer.pp,17,0.19298245614035087,8,9
wikimedia_puppet,modules/role/manifests/conftool/master.pp,2,0.75,2,0
wikimedia_puppet,modules/conftool/manifests/master.pp,2,0.6666666666666666,2,0
wikimedia_puppet,modules/phabricator/manifests/tools.pp,9,0.28,4,5
wikimedia_puppet,modules/varnish/manifests/common/director_scripts.pp,2,0.5,2,0
wikimedia_puppet,modules/varnish/manifests/common/directors.pp,5,0.3888888888888889,5,0
wikimedia_puppet,modules/pybal/manifests/pool.pp,2,0.75,2,0
wikimedia_puppet,manifests/role/bugzilla_static.pp,1,1.0,1,0
wikimedia_puppet,modules/bugzilla_static/manifests/init.pp,1,1.0,1,0
wikimedia_puppet,modules/labstore/manifests/fileserver.pp,6,0.4482758620689655,5,1
wikimedia_puppet,modules/labstore/manifests/init.pp,9,0.3333333333333333,9,0
wikimedia_puppet,manifests/role/relic.pp,3,0.3333333333333333,3,0
wikimedia_puppet,modules/varnish/manifests/logging/xcps.pp,5,0.625,5,0
wikimedia_puppet,modules/lvs/manifests/monitor_service6_http_https.pp,1,1.0,1,0
wikimedia_puppet,modules/lvs/manifests/monitor_service_http.pp,1,1.0,1,0
wikimedia_puppet,modules/lvs/manifests/monitor_service_http_https.pp,2,0.75,2,0
wikimedia_puppet,modules/eventlogging/manifests/monitoring/ganglia.pp,1,1.0,1,0
wikimedia_puppet,modules/eventlogging/manifests/monitoring/graphite.pp,9,0.23809523809523808,5,4
wikimedia_puppet,modules/eventlogging/manifests/monitoring/jobs.pp,2,0.6666666666666666,2,0
wikimedia_puppet,modules/statistics/manifests/aggregator/projectcounts.pp,2,0.6666666666666666,2,0
wikimedia_puppet,modules/statistics/manifests/aggregator/projectview.pp,4,0.42857142857142855,4,0
wikimedia_puppet,modules/labstore/manifests/monitoring.pp,3,0.5,3,0
wikimedia_puppet,modules/role/manifests/cache/ssl/unified.pp,3,0.6,3,0
wikimedia_puppet,manifests/role/tessera.pp,2,0.5,2,0
wikimedia_puppet,modules/tessera/manifests/init.pp,2,0.5,2,0
wikimedia_puppet,manifests/role/installserver.pp,6,0.47368421052631576,6,0
wikimedia_puppet,modules/install_server/manifests/apt-repository.pp,3,0.3333333333333333,3,0
wikimedia_puppet,modules/install_server/manifests/dhcp-server.pp,1,1.0,1,0
wikimedia_puppet,modules/install_server/manifests/preseed-server.pp,1,1.0,1,0
wikimedia_puppet,modules/install_server/manifests/tftp-server.pp,2,0.5,2,0
wikimedia_puppet,modules/install_server/manifests/web-server.pp,1,1.0,1,0
wikimedia_puppet,modules/install_server/spec/fixtures/manifests/site.pp,2,0.5,2,0
wikimedia_puppet,modules/install_server/tests/apt-repository.pp,1,1.0,1,0
wikimedia_puppet,modules/install_server/tests/dhcp-server.pp,1,1.0,1,0
wikimedia_puppet,modules/install_server/tests/preseed-server.pp,1,1.0,1,0
wikimedia_puppet,modules/install_server/tests/tftp-server.pp,1,1.0,1,0
wikimedia_puppet,modules/install_server/tests/web-server.pp,1,1.0,1,0
wikimedia_puppet,manifests/role/tlsproxy.pp,2,0.5,2,0
wikimedia_puppet,modules/tlsproxy/manifests/betassl.pp,1,1.0,1,0
wikimedia_puppet,modules/tlsproxy/manifests/instance.pp,8,0.44,3,5
wikimedia_puppet,modules/tlsproxy/manifests/localssl.pp,9,0.3235294117647059,5,4
wikimedia_puppet,modules/tlsproxy/manifests/ocsp_updater.pp,4,0.4444444444444444,4,0
wikimedia_puppet,modules/labstore/manifests/replica_accounts.pp,1,1.0,1,0
wikimedia_puppet,modules/labstore/manifests/replica_users.pp,2,0.5,2,0
wikimedia_puppet,modules/cassandra/manifests/init.pp,12,0.39655172413793105,6,6
wikimedia_puppet,modules/sslcert/manifests/std_cert.pp,1,1.0,1,0
wikimedia_puppet,modules/restbase/manifests/monitoring.pp,5,0.3333333333333333,5,0
wikimedia_puppet,modules/labstore/manifests/fileserver/exports/init.pp,1,1.0,1,0
wikimedia_puppet,modules/labstore/manifests/fileserver/exports/private.pp,2,0.75,2,0
wikimedia_puppet,modules/labstore/manifests/fileserver/exports/public.pp,1,1.0,1,0
wikimedia_puppet,modules/labstore/manifests/fileserver/init.pp,1,1.0,1,0
wikimedia_puppet,modules/labstore/manifests/fileserver/exports.pp,10,0.2692307692307692,5,5
wikimedia_puppet,modules/dataset/manifests/rsync/phab_dump.pp,2,0.6666666666666666,2,0
wikimedia_puppet,modules/puppetmaster/manifests/certcleaner.pp,2,0.6666666666666666,2,0
wikimedia_puppet,modules/varnish/manifests/logging/rls.pp,4,0.6923076923076923,4,0
wikimedia_puppet,modules/base/manifests/kernel.pp,5,0.625,5,0
wikimedia_puppet,modules/celery/manifests/worker.pp,3,0.5714285714285714,3,0
wikimedia_puppet,modules/ores/manifests/base.pp,9,0.37142857142857144,6,3
wikimedia_puppet,modules/ores/manifests/worker.pp,3,0.7142857142857143,3,0
wikimedia_puppet,modules/sslcert/manifests/dhparam.pp,2,0.5,2,0
wikimedia_puppet,modules/tlsproxy/manifests/ocsp_stapler.pp,3,0.5,3,0
wikimedia_puppet,modules/cassandra/manifests/metrics.pp,10,0.48,5,5
wikimedia_puppet,modules/releases/manifests/reprepro/upload.pp,2,0.5714285714285714,2,0
wikimedia_puppet,modules/pybal/manifests/conf_file.pp,1,1.0,1,0
wikimedia_puppet,modules/pybal/manifests/web/dc_pools.pp,1,1.0,1,0
wikimedia_puppet,modules/pybal/manifests/web/service.pp,2,0.8333333333333334,2,0
wikimedia_puppet,modules/contint/manifests/worker_localhost.pp,2,0.6666666666666666,2,0
wikimedia_puppet,manifests/role/nodepool.pp,6,0.45,6,0
wikimedia_puppet,modules/nodepool/manifests/init.pp,9,0.41379310344827586,5,4
wikimedia_puppet,modules/mediawiki_singlenode/manifests/mwextension.pp,1,1.0,1,0
wikimedia_puppet,manifests/role/maps.pp,5,0.8620689655172413,1,4
wikimedia_puppet,modules/service/manifests/monitoring.pp,2,0.8,2,0
wikimedia_puppet,modules/base/manifests/labs.pp,5,0.47058823529411764,5,0
wikimedia_puppet,modules/openstack/manifests/nova/novamigrate.pp,1,1.0,1,0
wikimedia_puppet,modules/openstack/manifests/nova/migrate.pp,1,1.0,1,0
wikimedia_puppet,manifests/role/wikilabels.pp,1,1.0,1,0
wikimedia_puppet,modules/wikilabels/manifests/db_proxy.pp,1,1.0,1,0
wikimedia_puppet,modules/wikilabels/manifests/session.pp,1,1.0,1,0
wikimedia_puppet,modules/wikilabels/manifests/web.pp,7,0.5384615384615384,7,0
wikimedia_puppet,manifests/role/kartotherian.pp,1,1.0,1,0
wikimedia_puppet,modules/kartotherian/manifests/init.pp,5,0.4166666666666667,3,2
wikimedia_puppet,modules/kartotherian/tests/init.pp,1,1.0,1,0
wikimedia_puppet,modules/celery/manifests/flower.pp,2,0.6666666666666666,2,0
wikimedia_puppet,modules/ores/manifests/flower.pp,2,0.5,2,0
wikimedia_puppet,modules/ganglia/manifests/plugin/python.pp,1,1.0,1,0
wikimedia_puppet,modules/ganglia/manifests/deprecated/collector.pp,3,0.5,3,0
wikimedia_puppet,manifests/role/wdqs.pp,6,0.2727272727272727,6,0
wikimedia_puppet,modules/wdqs/manifests/gui.pp,6,0.6551724137931034,4,2
wikimedia_puppet,modules/wdqs/manifests/init.pp,4,0.8055555555555556,3,1
wikimedia_puppet,modules/wdqs/manifests/monitor/blazegraph.pp,5,0.4,5,0
wikimedia_puppet,modules/wdqs/manifests/monitor/updater.pp,4,0.25,4,0
wikimedia_puppet,modules/wdqs/manifests/packages.pp,2,0.5,2,0
wikimedia_puppet,modules/wdqs/manifests/service.pp,9,0.34615384615384615,3,6
wikimedia_puppet,modules/wdqs/manifests/updater.pp,5,0.5714285714285714,5,0
wikimedia_puppet,modules/ganglia/manifests/init.pp,1,1.0,1,0
wikimedia_puppet,modules/ganglia/manifests/gmetad.pp,2,0.5,2,0
wikimedia_puppet,modules/ganglia/manifests/gmetad/rrdcached.pp,2,0.5,2,0
wikimedia_puppet,modules/ganglia/manifests/monitor.pp,3,0.3333333333333333,3,0
wikimedia_puppet,modules/ganglia/manifests/monitor/aggregator.pp,4,0.42857142857142855,4,0
wikimedia_puppet,modules/ganglia/manifests/web.pp,11,0.2,11,0
wikimedia_puppet,modules/ganglia/manifests/web/view.pp,1,1.0,1,0
wikimedia_puppet,modules/ganglia/tests/gmetad.pp,3,0.3333333333333333,3,0
wikimedia_puppet,modules/ganglia/tests/rrdcached.pp,2,0.5,2,0
wikimedia_puppet,modules/ganglia/tests/view.pp,1,1.0,1,0
wikimedia_puppet,modules/ganglia/tests/web.pp,2,0.5,2,0
wikimedia_puppet,manifests/role/labsmwvagrant.pp,1,1.0,1,0
wikimedia_puppet,modules/lxc/manifests/init.pp,4,0.4,4,0
wikimedia_puppet,modules/vagrant/manifests/init.pp,3,0.5,3,0
wikimedia_puppet,modules/vagrant/manifests/lxc.pp,6,0.25,6,0
wikimedia_puppet,modules/vagrant/manifests/mediawiki.pp,6,0.3076923076923077,6,0
wikimedia_puppet,modules/vagrant/manifests/plugin.pp,1,1.0,1,0
wikimedia_puppet,modules/contint/manifests/packages/python.pp,11,0.35294117647058826,11,0
wikimedia_puppet,modules/contint/manifests/packages/apt.pp,6,0.25,6,0
wikimedia_puppet,modules/labstore/manifests/fileserver/replicate.pp,5,0.5,5,0
wikimedia_puppet,modules/phragile/manifests/init.pp,3,0.5,3,0
wikimedia_puppet,modules/labstore/manifests/account_services.pp,7,0.4090909090909091,3,4
wikimedia_puppet,modules/cassandra/manifests/logging.pp,6,0.375,6,0
wikimedia_puppet,modules/logstash/manifests/input/udp.pp,4,0.3333333333333333,4,0
wikimedia_puppet,modules/osm/manifests/import_waterlines.pp,5,0.3333333333333333,5,0
wikimedia_puppet,modules/labstore/manifests/fileserver/cleanup_snapshots.pp,4,0.42857142857142855,4,0
wikimedia_puppet,manifests/role/lists.pp,6,0.5454545454545454,5,1
wikimedia_puppet,modules/nrpe/manifests/monitor_systemd_unit_lastrun.pp,1,1.0,1,0
wikimedia_puppet,modules/nrpe/manifests/monitor_systemd_unit_state.pp,5,0.5,5,0
wikimedia_puppet,manifests/role/debdeploy.pp,2,0.5,2,0
wikimedia_puppet,modules/debdeploy/manifests/init.pp,1,1.0,1,0
wikimedia_puppet,modules/base/manifests/debdeploy.pp,2,0.9166666666666666,2,0
wikimedia_puppet,modules/snapshot/manifests/dumps/stagesconf.pp,2,0.875,2,0
wikimedia_puppet,modules/snapshot/manifests/dumps/stagesconfig.pp,3,0.5416666666666666,2,1
wikimedia_puppet,modules/k8s/manifests/docker.pp,3,0.8571428571428571,3,0
wikimedia_puppet,modules/k8s/manifests/flannel.pp,4,0.5833333333333334,4,0
wikimedia_puppet,manifests/role/labsk8s.pp,2,0.5454545454545454,2,0
wikimedia_puppet,modules/k8s/manifests/kubelet.pp,4,0.40625,3,1
wikimedia_puppet,modules/rsyslog/manifests/receiver.pp,4,0.6363636363636364,4,0
wikimedia_puppet,modules/k8s/manifests/apiserver.pp,3,0.37209302325581395,3,0
wikimedia_puppet,modules/k8s/manifests/scheduler.pp,3,0.4444444444444444,3,0
wikimedia_puppet,modules/k8s/manifests/proxy.pp,4,0.47368421052631576,4,0
wikimedia_puppet,modules/k8s/manifests/controller.pp,3,0.5,3,0
wikimedia_puppet,modules/role/manifests/cache/maps.pp,9,0.4262295081967213,2,7
wikimedia_puppet,manifests/role/aptly.pp,5,0.45454545454545453,5,0
wikimedia_puppet,modules/aptly/manifests/init.pp,2,0.5,2,0
wikimedia_puppet,modules/apache/manifests/logrotate.pp,3,0.3333333333333333,3,0
wikimedia_puppet,manifests/role/scb.pp,3,0.8333333333333334,3,0
wikimedia_puppet,modules/role/manifests/ganeti.pp,4,0.5555555555555556,4,0
wikimedia_puppet,modules/logstash/manifests/output/elasticsearch/scripts.pp,4,0.5555555555555556,4,0
wikimedia_puppet,manifests/role/tilerator.pp,1,1.0,1,0
wikimedia_puppet,modules/tilerator/manifests/init.pp,4,0.36363636363636365,3,1
wikimedia_puppet,modules/tilerator/tests/init.pp,1,1.0,1,0
wikimedia_puppet,modules/logstash/manifests/output/statsd.pp,3,0.3333333333333333,3,0
wikimedia_puppet,manifests/role/mobileapps.pp,2,0.6666666666666666,2,0
wikimedia_puppet,modules/mobileapps/manifests/init.pp,5,0.3333333333333333,5,0
wikimedia_puppet,modules/mobileapps/tests/init.pp,1,1.0,1,0
wikimedia_puppet,modules/puppet_compiler/manifests/setup.pp,2,0.8571428571428571,2,0
wikimedia_puppet,modules/puppet_compiler/manifests/web.pp,2,0.6,2,0
wikimedia_puppet,modules/swift/manifests/container_sync.pp,1,1.0,1,0
wikimedia_puppet,modules/swift/manifests/init.pp,3,0.7,3,0
wikimedia_puppet,modules/swift/manifests/init_device.pp,2,0.6666666666666666,2,0
wikimedia_puppet,modules/swift/manifests/label_filesystem.pp,1,1.0,1,0
wikimedia_puppet,modules/swift/manifests/monitoring/graphite.pp,1,1.0,1,0
wikimedia_puppet,modules/swift/manifests/mount_filesystem.pp,1,1.0,1,0
wikimedia_puppet,modules/swift/manifests/params.pp,1,1.0,1,0
wikimedia_puppet,modules/swift/manifests/proxy.pp,2,0.8461538461538461,2,0
wikimedia_puppet,modules/swift/manifests/ring.pp,2,0.6666666666666666,2,0
wikimedia_puppet,modules/swift/manifests/stats/accounts.pp,1,1.0,1,0
wikimedia_puppet,modules/swift/manifests/stats/dispersion.pp,1,1.0,1,0
wikimedia_puppet,modules/swift/manifests/stats/stats_account.pp,1,1.0,1,0
wikimedia_puppet,modules/swift/manifests/storage.pp,3,0.7777777777777778,3,0
wikimedia_puppet,modules/swift/manifests/storage/monitor_swift_daemon.pp,2,0.5,2,0
wikimedia_puppet,modules/swift/manifests/storage/monitoring.pp,2,0.6666666666666666,2,0
wikimedia_puppet,manifests/role/labsvagrantlxc.pp,1,1.0,1,0
wikimedia_puppet,modules/service/manifests/deployment_script.pp,1,1.0,1,0
wikimedia_puppet,modules/mailman/manifests/cron.pp,3,0.6,3,0
wikimedia_puppet,modules/ores/manifests/precached.pp,4,0.4,4,0
wikimedia_puppet,modules/aptly/manifests/client.pp,5,0.5384615384615384,5,0
wikimedia_puppet,modules/phabricator/manifests/mpm.pp,2,0.5,2,0
wikimedia_puppet,modules/mediawiki/manifests/nutcracker.pp,2,0.6,2,0
wikimedia_puppet,modules/keyholder/manifests/agent.pp,9,0.25,9,0
wikimedia_puppet,modules/aptly/manifests/repo.pp,3,0.5714285714285714,3,0
wikimedia_puppet,modules/icinga/manifests/monitor/legal.pp,3,0.5555555555555556,3,0
wikimedia_puppet,modules/k8s/manifests/webproxy.pp,2,0.8,2,0
wikimedia_puppet,modules/diamond/manifests/collector/servicestats.pp,4,0.4,4,0
wikimedia_puppet,modules/wdqs/manifests/monitor/services.pp,7,0.5,7,0
wikimedia_puppet,manifests/role/tools.pp,3,0.6944444444444444,3,0
wikimedia_puppet,modules/toollabs/manifests/genpp/python_dev_jessie.pp,1,1.0,1,0
wikimedia_puppet,modules/toollabs/manifests/genpp/python_dev_precise.pp,1,1.0,1,0
wikimedia_puppet,modules/toollabs/manifests/genpp/python_dev_trusty.pp,1,1.0,1,0
wikimedia_puppet,modules/toollabs/manifests/genpp/python_exec_jessie.pp,4,0.7692307692307693,4,0
wikimedia_puppet,modules/toollabs/manifests/genpp/python_exec_precise.pp,3,0.8333333333333334,3,0
wikimedia_puppet,modules/toollabs/manifests/genpp/python_exec_trusty.pp,4,0.7692307692307693,4,0
wikimedia_puppet,modules/swift/manifests/monitoring/graphite_alerts.pp,3,0.5714285714285714,3,0
wikimedia_puppet,modules/k8s/manifests/apiserver_ssl.pp,1,1.0,1,0
wikimedia_puppet,modules/k8s/manifests/ssl.pp,2,0.625,2,0
wikimedia_puppet,modules/k8s/manifests/users.pp,3,0.6,3,0
wikimedia_puppet,modules/cassandra/manifests/ca_manager.pp,2,0.5,2,0
wikimedia_puppet,modules/varnish/manifests/logging/media.pp,4,0.7692307692307693,4,0
wikimedia_puppet,manifests/role/labsphragile.pp,1,1.0,1,0
wikimedia_puppet,manifests/role/analytics/mysql.pp,4,0.3333333333333333,4,0
wikimedia_puppet,modules/mediawiki/manifests/maintenance/cleanup_upload_stash.pp,1,1.0,1,0
wikimedia_puppet,modules/mediawiki/manifests/maintenance/echo_mail_batch.pp,2,0.5,2,0
wikimedia_puppet,modules/mediawiki/manifests/maintenance/pagetriage.pp,2,0.6666666666666666,2,0
wikimedia_puppet,modules/mediawiki/manifests/maintenance/parsercachepurging.pp,3,0.6,3,0
wikimedia_puppet,modules/mediawiki/manifests/maintenance/purge_abusefilter.pp,4,0.42857142857142855,4,0
wikimedia_puppet,modules/mediawiki/manifests/maintenance/purge_checkuser.pp,2,0.5,2,0
wikimedia_puppet,modules/mediawiki/manifests/maintenance/purge_securepoll.pp,3,0.3333333333333333,3,0
wikimedia_puppet,modules/mediawiki/manifests/maintenance/refreshlinks.pp,5,0.4444444444444444,5,0
wikimedia_puppet,modules/mediawiki/manifests/maintenance/tor_exit_node.pp,2,0.6666666666666666,2,0
wikimedia_puppet,modules/mediawiki/manifests/maintenance/translationnotifications.pp,3,0.3333333333333333,3,0
wikimedia_puppet,modules/mediawiki/manifests/maintenance/update_article_count.pp,1,1.0,1,0
wikimedia_puppet,modules/mediawiki/manifests/maintenance/update_flaggedrev_stats.pp,2,0.5,2,0
wikimedia_puppet,modules/mediawiki/manifests/maintenance/update_special_pages.pp,1,1.0,1,0
wikimedia_puppet,modules/mediawiki/manifests/maintenance/updatequerypages.pp,5,0.3333333333333333,5,0
wikimedia_puppet,modules/mediawiki/manifests/maintenance/updatetranslationstats.pp,1,1.0,1,0
wikimedia_puppet,modules/mediawiki/manifests/maintenance/wikidata.pp,16,0.21568627450980393,7,9
wikimedia_puppet,modules/k8s/manifests/client.pp,1,1.0,1,0
wikimedia_puppet,modules/contint/manifests/packages/base.pp,1,1.0,1,0
wikimedia_puppet,modules/otrs/manifests/init.pp,2,0.8947368421052632,2,0
wikimedia_puppet,modules/otrs/manifests/mail.pp,3,0.4,3,0
wikimedia_puppet,modules/otrs/manifests/web.pp,4,0.42857142857142855,4,0
wikimedia_puppet,modules/otrs/tests/mail.pp,1,1.0,1,0
wikimedia_puppet,modules/otrs/tests/otrs.pp,1,1.0,1,0
wikimedia_puppet,modules/otrs/tests/web.pp,2,0.5,2,0
wikimedia_puppet,modules/elasticsearch/manifests/monitor/diamond.pp,2,0.5,2,0
wikimedia_puppet,manifests/role/sentry.pp,1,1.0,1,0
wikimedia_puppet,modules/postgresql/manifests/db.pp,4,0.4,4,0
wikimedia_puppet,modules/sentry/manifests/init.pp,8,0.3333333333333333,8,0
wikimedia_puppet,modules/apache/manifests/static_site.pp,1,1.0,1,0
wikimedia_puppet,modules/contint/manifests/packages/ops.pp,4,0.5,4,0
wikimedia_puppet,modules/restbase/manifests/deploy.pp,4,0.4,4,0
wikimedia_puppet,modules/sentry/manifests/packages.pp,1,1.0,1,0
wikimedia_puppet,modules/etcd/manifests/ssl/base.pp,2,0.5,2,0
wikimedia_puppet,modules/toolserver_legacy/manifests/init.pp,6,0.36363636363636365,6,0
wikimedia_puppet,modules/toollabs/manifests/kube2proxy.pp,6,0.34615384615384615,4,2
wikimedia_puppet,manifests/role/aqs.pp,8,0.25,5,3
wikimedia_puppet,modules/cassandra/manifests/instance.pp,11,0.46153846153846156,6,5
wikimedia_puppet,modules/contint/manifests/packages/ruby.pp,6,0.45454545454545453,6,0
wikimedia_puppet,modules/sslcert/manifests/ocsp/conf.pp,1,1.0,1,0
wikimedia_puppet,modules/sslcert/manifests/ocsp/hook.pp,1,1.0,1,0
wikimedia_puppet,modules/sslcert/manifests/ocsp/init.pp,3,0.5,3,0
wikimedia_puppet,modules/tlsproxy/manifests/ocsp.pp,3,0.5,3,0
wikimedia_puppet,modules/toollabs/manifests/puppetmaster.pp,2,0.6666666666666666,2,0
wikimedia_puppet,modules/swift/manifests/stats/stats_container.pp,2,0.5,2,0
wikimedia_puppet,modules/logstash/manifests/input/kafka.pp,3,0.3333333333333333,3,0
wikimedia_puppet,manifests/role/labswdq_mm.pp,1,1.0,1,0
wikimedia_puppet,modules/wdq_mm/manifests/init.pp,1,1.0,1,0
wikimedia_puppet,modules/wdq_mm/manifests/lb.pp,1,1.0,1,0
wikimedia_puppet,manifests/role/mw_rc_irc.pp,3,0.6,3,0
wikimedia_puppet,modules/mw_rc_irc/manifests/apache.pp,2,0.5,2,0
wikimedia_puppet,modules/mw_rc_irc/manifests/irc-echo.pp,2,0.5,2,0
wikimedia_puppet,modules/mw_rc_irc/manifests/ircserver.pp,5,0.6666666666666666,5,0
wikimedia_puppet,modules/camus/manifests/init.pp,4,0.25,4,0
wikimedia_puppet,modules/camus/manifests/job.pp,3,0.7,3,0
wikimedia_puppet,modules/labs_debrepo/manifests/init.pp,2,0.5,2,0
wikimedia_puppet,modules/labs_debrepo/manifests/repo.pp,3,0.5,3,0
wikimedia_puppet,modules/k8s/manifests/infrastructure_config.pp,4,0.3333333333333333,4,0
wikimedia_puppet,manifests/role/grafana2.pp,2,0.6666666666666666,2,0
wikimedia_puppet,modules/grafana2/manifests/init.pp,2,0.6666666666666666,2,0
wikimedia_puppet,modules/grafana/manifests/dashboard.pp,2,0.6666666666666666,2,0
wikimedia_puppet,manifests/role/spare.pp,3,0.3333333333333333,3,0
wikimedia_puppet,manifests/role/testsystem.pp,1,1.0,1,0
wikimedia_puppet,modules/toollabs/manifests/composer.pp,4,0.3333333333333333,4,0
wikimedia_puppet,modules/icinga/manifests/monitor/certs.pp,9,0.38461538461538464,3,6
wikimedia_puppet,modules/tilerator/manifests/ui.pp,4,0.5217391304347826,3,1
wikimedia_puppet,modules/mediawiki/manifests/maintenance/jobqueue_stats.pp,2,0.5,2,0
wikimedia_puppet,modules/role/manifests/puppetmaster/backend.pp,5,0.42105263157894735,5,0
wikimedia_puppet,modules/role/manifests/puppetmaster/frontend.pp,6,0.4146341463414634,3,3
wikimedia_puppet,modules/role/manifests/puppetmaster/labs.pp,1,1.0,1,0
wikimedia_puppet,modules/dataset/manifests/user.pp,2,0.6666666666666666,2,0
wikimedia_puppet,modules/varnish/manifests/logging/reqstats.pp,7,0.47058823529411764,7,0
wikimedia_puppet,modules/mediawiki/manifests/web/prod_sites.pp,7,0.8571428571428571,1,6
wikimedia_puppet,modules/scap/manifests/dsh.pp,3,0.7142857142857143,3,0
wikimedia_puppet,modules/dataset/manifests/cron/pageviews.pp,1,1.0,1,0
wikimedia_puppet,modules/toollabs/manifests/monitoring/icinga.pp,7,0.3333333333333333,7,0
wikimedia_puppet,modules/toollabs/manifests/monitoring/shinken.pp,2,0.5,2,0
wikimedia_puppet,modules/role/manifests/deployment/config.pp,1,1.0,1,0
wikimedia_puppet,modules/role/manifests/deployment/mediawiki.pp,9,0.5263157894736842,9,0
wikimedia_puppet,modules/role/manifests/deployment/salt_masters.pp,4,0.3333333333333333,4,0
wikimedia_puppet,modules/role/manifests/deployment/server.pp,15,0.2826086956521739,4,11
wikimedia_puppet,modules/role/manifests/deployment/services.pp,1,1.0,1,0
wikimedia_puppet,modules/role/manifests/deployment/test.pp,1,1.0,1,0
wikimedia_puppet,modules/deployment/manifests/wikitech.pp,2,0.5,2,0
wikimedia_puppet,manifests/role/analytics/burrow.pp,3,0.6666666666666666,3,0
wikimedia_puppet,modules/burrow/manifests/init.pp,6,0.4375,6,0
wikimedia_puppet,modules/dataset/manifests/cron/job.pp,2,0.6666666666666666,2,0
wikimedia_puppet,modules/snapshot/manifests/cirrussearch.pp,1,1.0,1,0
wikimedia_puppet,modules/role/manifests/openldap/corp.pp,5,0.5263157894736842,5,0
wikimedia_puppet,modules/dnsrecursor/manifests/labsaliaser.pp,8,0.3888888888888889,8,0
wikimedia_puppet,modules/mediawiki/manifests/web/php_engine.pp,3,0.5,3,0
wikimedia_puppet,modules/ldap/manifests/client/includes.pp,2,0.6666666666666666,2,0
wikimedia_puppet,modules/ldap/manifests/client/nss.pp,6,0.3333333333333333,6,0
wikimedia_puppet,modules/ldap/manifests/client/openldap.pp,1,1.0,1,0
wikimedia_puppet,modules/ldap/manifests/client/pam.pp,3,0.5,3,0
wikimedia_puppet,modules/ldap/manifests/client/sudo.pp,1,1.0,1,0
wikimedia_puppet,modules/ldap/manifests/client/utils.pp,5,0.5,5,0
wikimedia_puppet,modules/openldap/manifests/ldap_schema.pp,2,0.5,2,0
wikimedia_puppet,modules/redis/manifests/legacy.pp,1,1.0,1,0
wikimedia_puppet,modules/docker/manifests/registry/init.pp,1,1.0,1,0
wikimedia_puppet,modules/docker/manifests/registry.pp,4,0.4090909090909091,4,0
wikimedia_puppet,manifests/role/labs/openstack/designate.pp,2,0.5,2,0
wikimedia_puppet,manifests/role/labs/openstack/glance.pp,2,0.5,2,0
wikimedia_puppet,manifests/role/labs/openstack/keystone.pp,2,0.5,2,0
wikimedia_puppet,manifests/role/labs/openstack/nova.pp,3,0.3333333333333333,3,0
wikimedia_puppet,manifests/role/labs/puppetmaster.pp,2,0.5,2,0
wikimedia_puppet,modules/tendril/manifests/maintenance.pp,3,0.625,3,0
wikimedia_puppet,modules/redis/manifests/instance.pp,5,0.3333333333333333,5,0
wikimedia_puppet,modules/role/manifests/scap/target.pp,1,1.0,1,0
wikimedia_puppet,modules/scap/manifests/init.pp,13,0.5483870967741935,3,10
wikimedia_puppet,modules/etherpad/manifests/autorestarter.pp,1,1.0,1,0
wikimedia_puppet,modules/librenms/manifests/web.pp,6,0.38461538461538464,6,0
wikimedia_puppet,manifests/role/simplelamp.pp,4,0.4,4,0
wikimedia_puppet,manifests/role/simplelap.pp,1,1.0,1,0
wikimedia_puppet,modules/base/manifests/mysterious_sysctl.pp,1,1.0,1,0
wikimedia_puppet,modules/role/manifests/salt/masters/labs.pp,6,0.2857142857142857,6,0
wikimedia_puppet,modules/role/manifests/salt/masters/labs/project_master.pp,4,0.25,4,0
wikimedia_puppet,modules/role/manifests/salt/masters/production.pp,9,0.23076923076923078,9,0
wikimedia_puppet,modules/role/manifests/salt/minions.pp,9,0.18181818181818182,9,0
wikimedia_puppet,manifests/role/mattermost.pp,1,1.0,1,0
wikimedia_puppet,modules/mattermost/manifests/server.pp,2,0.75,2,0
wikimedia_puppet,modules/mattermost/manifests/matterircd.pp,1,1.0,1,0
wikimedia_puppet,modules/trebuchet/manifests/init.pp,4,0.4,4,0
wikimedia_puppet,manifests/role/puppetmaster/backend.pp,1,1.0,1,0
wikimedia_puppet,manifests/role/puppetmaster/frontend.pp,1,1.0,1,0
wikimedia_puppet,modules/toollabs/manifests/node/init.pp,1,1.0,1,0
wikimedia_puppet,modules/toollabs/manifests/node/all.pp,5,0.3333333333333333,5,0
wikimedia_puppet,modules/role/manifests/labs/bastion.pp,4,0.25,4,0
wikimedia_puppet,modules/role/manifests/labs/db/master.pp,7,0.4117647058823529,7,0
wikimedia_puppet,modules/role/manifests/labs/db/slave.pp,7,0.4375,7,0
wikimedia_puppet,modules/role/manifests/labs/instance.pp,8,0.23809523809523808,6,2
wikimedia_puppet,modules/role/manifests/labs/lvm/mnt.pp,3,0.3333333333333333,3,0
wikimedia_puppet,modules/role/manifests/labs/lvm/srv.pp,3,0.3333333333333333,3,0
wikimedia_puppet,modules/role/manifests/labs/mediawiki_vagrant.pp,3,0.625,3,0
wikimedia_puppet,modules/role/manifests/labs/nfs/extras.pp,2,0.5,2,0
wikimedia_puppet,modules/role/manifests/labs/nfs/fileserver.pp,3,0.5,3,0
wikimedia_puppet,modules/role/manifests/labs/novaproxy.pp,7,0.16666666666666666,7,0
wikimedia_puppet,modules/role/manifests/labs/openstack/designate.pp,6,0.3333333333333333,6,0
wikimedia_puppet,modules/role/manifests/labs/openstack/glance.pp,3,0.5,3,0
wikimedia_puppet,modules/role/manifests/labs/openstack/keystone.pp,5,0.4166666666666667,5,0
wikimedia_puppet,modules/role/manifests/labs/openstack/nova.pp,14,0.2545454545454545,6,8
wikimedia_puppet,modules/role/manifests/labs/puppetmaster.pp,5,0.3448275862068966,5,0
wikimedia_puppet,modules/role/manifests/labs/shinken.pp,4,0.5,4,0
wikimedia_puppet,modules/role/manifests/labs/vmbuilder.pp,2,0.5,2,0
wikimedia_puppet,modules/role/manifests/labs/dns.pp,9,0.25806451612903225,6,3
wikimedia_puppet,modules/role/manifests/labs/dnsrecursor.pp,11,0.2777777777777778,7,4
wikimedia_puppet,manifests/role/phragile.pp,1,1.0,1,0
wikimedia_puppet,modules/role/manifests/labs/graphite.pp,8,0.35714285714285715,8,0
wikimedia_puppet,modules/role/manifests/deprecated/mediawiki.pp,1,1.0,1,0
wikimedia_puppet,manifests/role/wdq_mm.pp,2,0.5,2,0
wikimedia_puppet,modules/varnish/manifests/monitoring/instance.pp,2,0.6666666666666666,2,0
wikimedia_puppet,modules/elasticsearch/manifests/proxy.pp,3,0.3333333333333333,3,0
wikimedia_puppet,manifests/monitoring_groups.pp,1,1.0,1,0
wikimedia_puppet,modules/role/manifests/deprecated/labsvagrant.pp,1,1.0,1,0
wikimedia_puppet,modules/role/manifests/openldap/labs.pp,8,0.34615384615384615,5,3
wikimedia_puppet,modules/role/manifests/labs/openstack/nodepool.pp,3,0.5,3,0
wikimedia_puppet,manifests/role/jobqueue_redis.pp,3,0.42857142857142855,3,0
wikimedia_puppet,modules/mediawiki/manifests/jobqueue_redis.pp,3,0.42857142857142855,3,0
wikimedia_puppet,modules/ores/manifests/monitoring.pp,1,1.0,1,0
wikimedia_puppet,modules/varnish/manifests/remove_instance.pp,2,0.5,2,0
wikimedia_puppet,modules/icinga/manifests/monitor/ores.pp,4,0.6666666666666666,4,0
wikimedia_puppet,modules/icinga/manifests/monitor/gsb.pp,1,1.0,1,0
wikimedia_puppet,modules/phabricator/manifests/arcanist.pp,2,0.5,2,0
wikimedia_puppet,modules/icinga/manifests/groups/labs.pp,1,1.0,1,0
wikimedia_puppet,modules/etcd/manifests/client/config.pp,1,1.0,1,0
wikimedia_puppet,modules/etcd/manifests/client/globalconfig.pp,2,0.6,2,0
wikimedia_puppet,modules/pybal/manifests/monitoring.pp,6,0.26666666666666666,6,0
wikimedia_puppet,modules/security/manifests/access.pp,1,1.0,1,0
wikimedia_puppet,modules/security/manifests/access/config.pp,2,0.5,2,0
wikimedia_puppet,modules/security/manifests/pam.pp,1,1.0,1,0
wikimedia_puppet,modules/security/manifests/pam/config.pp,1,1.0,1,0
wikimedia_puppet,modules/role/manifests/elasticsearch/server.pp,6,0.3333333333333333,6,0
wikimedia_puppet,modules/role/manifests/zookeeper/client.pp,5,0.4,5,0
wikimedia_puppet,modules/role/manifests/zookeeper/server.pp,7,0.21428571428571427,7,0
wikimedia_puppet,modules/contint/manifests/packages/javascript.pp,5,0.2857142857142857,5,0
wikimedia_puppet,modules/role/manifests/zuul/configuration.pp,4,0.25,4,0
wikimedia_puppet,modules/role/manifests/zuul/install.pp,1,1.0,1,0
wikimedia_puppet,modules/role/manifests/zuul/merger.pp,3,0.6666666666666666,3,0
wikimedia_puppet,modules/role/manifests/zuul/server.pp,5,0.6,5,0
wikimedia_puppet,manifests/role/simplestatic.pp,3,0.3333333333333333,3,0
wikimedia_puppet,modules/contint/manifests/slave_scripts.pp,4,0.5555555555555556,4,0
wikimedia_puppet,modules/nagios_common/manifests/contactgroups.pp,2,0.5,2,0
wikimedia_puppet,modules/base/manifests/instance_upstarts.pp,1,1.0,1,0
wikimedia_puppet,modules/ganglia/manifests/cluster.pp,1,1.0,1,0
wikimedia_puppet,modules/puppetmaster/manifests/base_repo.pp,1,1.0,1,0
wikimedia_puppet,modules/role/manifests/kafka/analytics/broker.pp,11,0.3111111111111111,5,6
wikimedia_puppet,modules/role/manifests/kafka/analytics/config.pp,1,1.0,1,0
wikimedia_puppet,modules/role/manifests/kafka/main/broker.pp,6,0.4642857142857143,4,2
wikimedia_puppet,modules/role/manifests/kafka/main/config.pp,1,1.0,1,0
wikimedia_puppet,modules/cxserver/tests/init.pp,1,1.0,1,0
wikimedia_puppet,modules/mediawiki/manifests/maintenance/cirrussearch.pp,5,0.4166666666666667,5,0
wikimedia_puppet,modules/scap/manifests/ferm.pp,1,1.0,1,0
wikimedia_puppet,modules/scap/manifests/target.pp,12,0.21739130434782608,6,6
wikimedia_puppet,modules/eventlogging/manifests/deployment/source.pp,3,0.3333333333333333,3,0
wikimedia_puppet,modules/eventlogging/manifests/service/service.pp,7,0.48148148148148145,4,3
wikimedia_puppet,modules/role/manifests/eventbus/eventbus.pp,9,0.5,2,7
wikimedia_puppet,modules/ores/manifests/config.pp,2,0.6666666666666666,2,0
wikimedia_puppet,modules/role/manifests/pybal/testing.pp,1,1.0,1,0
wikimedia_puppet,modules/tor/manifests/instance.pp,1,1.0,1,0
wikimedia_puppet,modules/dnsrecursor/manifests/metalresolver.pp,2,0.6666666666666666,2,0
wikimedia_puppet,modules/bacula/manifests/client/mysql_bpipe.pp,2,0.6666666666666666,2,0
wikimedia_puppet,modules/base/manifests/standard_packages.pp,16,0.3050847457627119,6,10
wikimedia_puppet,modules/osm/manifests/users.pp,1,1.0,1,0
wikimedia_puppet,modules/udp2log/manifests/init.pp,3,0.3333333333333333,3,0
wikimedia_puppet,modules/udp2log/manifests/instance.pp,6,0.4,6,0
wikimedia_puppet,modules/udp2log/manifests/instance/monitoring.pp,3,0.5,3,0
wikimedia_puppet,modules/udp2log/manifests/monitoring.pp,3,0.6666666666666666,3,0
wikimedia_puppet,modules/udp2log/manifests/rsyncd.pp,4,0.25,4,0
wikimedia_puppet,modules/contint/manifests/zuul/git_daemon.pp,4,0.3333333333333333,4,0
wikimedia_puppet,modules/mw_rc_irc/manifests/irc_echo.pp,2,0.8,2,0
wikimedia_puppet,modules/snapshot/manifests/wikidatadumps/common.pp,3,0.5,3,0
wikimedia_puppet,modules/snapshot/manifests/wikidatadumps/json.pp,1,1.0,1,0
wikimedia_puppet,modules/snapshot/manifests/wikidatadumps/ttl.pp,1,1.0,1,0
wikimedia_puppet,modules/role/manifests/package/builder.pp,3,0.5,3,0
wikimedia_puppet,modules/openstack/manifests/openstack_manager.pp,8,0.3684210526315789,8,0
wikimedia_puppet,modules/openstack/manifests/queue_server.pp,4,0.36363636363636365,4,0
wikimedia_puppet,manifests/role/piwik.pp,3,0.4,3,0
wikimedia_puppet,modules/role/manifests/bugzilla/static.pp,1,1.0,1,0
wikimedia_puppet,modules/role/manifests/dataset/primary.pp,6,0.3157894736842105,6,0
wikimedia_puppet,modules/role/manifests/dataset/secondary.pp,4,0.375,4,0
wikimedia_puppet,manifests/role/testreduce.pp,1,1.0,1,0
wikimedia_puppet,modules/testreduce/manifests/init.pp,3,0.6,3,0
wikimedia_puppet,modules/snapshot/manifests/dumps/monitor.pp,4,0.5714285714285714,4,0
wikimedia_puppet,modules/role/manifests/tor/relay.pp,1,1.0,1,0
wikimedia_puppet,modules/etcd/manifests/auth.pp,2,0.75,2,0
wikimedia_puppet,modules/etcd/manifests/auth/common.pp,2,0.8,2,0
wikimedia_puppet,modules/etcd/manifests/auth/users.pp,1,1.0,1,0
wikimedia_puppet,modules/conftool/manifests/credentials.pp,2,0.8,2,0
wikimedia_puppet,modules/conftool/manifests/scripts.pp,3,0.7142857142857143,3,0
wikimedia_puppet,modules/role/manifests/ganglia/config.pp,1,1.0,1,0
wikimedia_puppet,modules/role/manifests/ganglia/web.pp,5,0.4666666666666667,5,0
wikimedia_puppet,modules/role/manifests/osm/common.pp,6,0.4,6,0
wikimedia_puppet,modules/role/manifests/osm/master.pp,5,0.5263157894736842,5,0
wikimedia_puppet,modules/role/manifests/osm/slave.pp,4,0.45454545454545453,4,0
wikimedia_puppet,manifests/role/parsoid-rt-client.pp,2,0.5,2,0
wikimedia_puppet,manifests/role/parsoid-rt-server.pp,2,0.5,2,0
wikimedia_puppet,modules/testreduce/manifests/client.pp,4,0.5,4,0
wikimedia_puppet,modules/testreduce/manifests/server.pp,4,0.4,4,0
wikimedia_puppet,modules/role/manifests/openldap/labtest.pp,5,0.3333333333333333,5,0
wikimedia_puppet,modules/wikimetrics/manifests/base.pp,2,0.5,2,0
wikimedia_puppet,modules/wikimetrics/manifests/queue.pp,3,0.3333333333333333,3,0
wikimedia_puppet,modules/wikimetrics/manifests/redis.pp,3,0.3333333333333333,3,0
wikimedia_puppet,modules/wikimetrics/manifests/scheduler.pp,3,0.3333333333333333,3,0
wikimedia_puppet,modules/wikimetrics/manifests/web.pp,4,0.5555555555555556,4,0
wikimedia_puppet,manifests/role/rsync_ruthenium.pp,1,1.0,1,0
wikimedia_puppet,modules/toollabs/manifests/cronrunner.pp,4,0.6666666666666666,4,0
wikimedia_puppet,modules/deployment/manifests/redis.pp,4,0.7,4,0
wikimedia_puppet,modules/deployment/manifests/rsync.pp,2,0.8,2,0
wikimedia_puppet,modules/install_server/manifests/apt_repository.pp,3,0.3333333333333333,3,0
wikimedia_puppet,modules/install_server/manifests/dhcp_server.pp,2,0.75,2,0
wikimedia_puppet,modules/install_server/manifests/preseed_server.pp,1,1.0,1,0
wikimedia_puppet,modules/install_server/manifests/tftp_server.pp,2,0.8333333333333334,2,0
wikimedia_puppet,modules/install_server/manifests/web_server.pp,5,0.3333333333333333,5,0
wikimedia_puppet,modules/install_server/tests/apt_repository.pp,1,1.0,1,0
wikimedia_puppet,modules/install_server/tests/dhcp_server.pp,1,1.0,1,0
wikimedia_puppet,modules/install_server/tests/preseed_server.pp,1,1.0,1,0
wikimedia_puppet,modules/install_server/tests/tftp_server.pp,1,1.0,1,0
wikimedia_puppet,modules/install_server/tests/web_server.pp,1,1.0,1,0
wikimedia_puppet,modules/lvs/manifests/interface_tweaks.pp,4,0.5,4,0
wikimedia_puppet,modules/role/manifests/bastionhost/general.pp,5,0.4444444444444444,5,0
wikimedia_puppet,modules/role/manifests/bastionhost/opsonly.pp,4,0.25,4,0
wikimedia_puppet,modules/role/manifests/debdeploy/master.pp,2,0.6666666666666666,2,0
wikimedia_puppet,modules/toollabs/manifests/bigbrother.pp,3,0.6,3,0
wikimedia_puppet,modules/role/manifests/graphite/alerts.pp,9,0.25,9,0
wikimedia_puppet,modules/role/manifests/graphite/alerts/reqstats.pp,7,0.18181818181818182,7,0
wikimedia_puppet,modules/role/manifests/graphite/base.pp,11,0.25806451612903225,6,5
wikimedia_puppet,modules/role/manifests/graphite/production.pp,9,0.53125,5,4
wikimedia_puppet,modules/role/manifests/mha/manager.pp,3,0.4,3,0
wikimedia_puppet,modules/role/manifests/mha/node.pp,2,0.5,2,0
wikimedia_puppet,modules/toollabs/manifests/updatetools.pp,3,0.4,3,0
wikimedia_puppet,modules/role/manifests/mattermost/server.pp,1,1.0,1,0
wikimedia_puppet,modules/role/manifests/ceilometer/compute.pp,1,1.0,1,0
wikimedia_puppet,modules/role/manifests/ceilometer/controller.pp,1,1.0,1,0
wikimedia_puppet,manifests/role/parsoid-vd-client.pp,1,1.0,1,0
wikimedia_puppet,manifests/role/parsoid-vd-server.pp,1,1.0,1,0
wikimedia_puppet,modules/visualdiff/manifests/init.pp,6,0.5,6,0
wikimedia_puppet,modules/visualdiff/manifests/server.pp,2,0.6666666666666666,2,0
wikimedia_puppet,manifests/role/parsoid_rt_client.pp,3,0.5,3,0
wikimedia_puppet,manifests/role/parsoid_rt_server.pp,2,0.5,2,0
wikimedia_puppet,manifests/role/parsoid_vd_client.pp,1,1.0,1,0
wikimedia_puppet,manifests/role/parsoid_vd_server.pp,2,0.5,2,0
wikimedia_puppet,modules/openstack/manifests/wikitechprivatesettings.pp,2,0.5,2,0
wikimedia_puppet,modules/role/manifests/kafka/analytics/mirror.pp,2,0.75,2,0
wikimedia_puppet,modules/role/manifests/elasticsearch/alerts.pp,4,0.375,4,0
wikimedia_puppet,manifests/role/rsync_caesium.pp,1,1.0,1,0
wikimedia_puppet,modules/role/manifests/elasticsearch/analytics.pp,4,0.5,4,0
wikimedia_puppet,manifests/role/analytics/users.pp,1,1.0,1,0
wikimedia_puppet,modules/snapshot/manifests/dumps/cron.pp,3,0.5185185185185185,2,1
wikimedia_puppet,modules/snapshot/manifests/dumps/cron/huge.pp,2,0.6666666666666666,2,0
wikimedia_puppet,modules/snapshot/manifests/dumps/cron/rest.pp,2,0.6666666666666666,2,0
wikimedia_puppet,modules/toollabs/manifests/admin_web_updater.pp,3,0.5,3,0
wikimedia_puppet,modules/role/manifests/pentest/tools.pp,2,0.5,2,0
wikimedia_puppet,modules/snapshot/manifests/wikiqueryskip.pp,2,0.6666666666666666,2,0
wikimedia_puppet,modules/salt/manifests/master/key.pp,2,0.8,2,0
wikimedia_puppet,modules/role/manifests/analytics_new/database/meta.pp,1,1.0,1,0
wikimedia_puppet,modules/role/manifests/analytics_new/hadoop/client.pp,1,1.0,1,0
wikimedia_puppet,modules/role/manifests/analytics_new/hadoop/ferm/namenode.pp,1,1.0,1,0
wikimedia_puppet,modules/role/manifests/analytics_new/hadoop/ferm/resourcemanager.pp,1,1.0,1,0
wikimedia_puppet,modules/role/manifests/analytics_new/hadoop/master.pp,1,1.0,1,0
wikimedia_puppet,modules/role/manifests/analytics_new/hadoop/standby.pp,1,1.0,1,0
wikimedia_puppet,modules/role/manifests/analytics_new/hadoop/worker.pp,1,1.0,1,0
wikimedia_puppet,modules/role/manifests/analytics_new/hive/client.pp,1,1.0,1,0
wikimedia_puppet,modules/role/manifests/analytics_new/hive/metastore.pp,1,1.0,1,0
wikimedia_puppet,modules/role/manifests/analytics_new/hive/metastore/database.pp,1,1.0,1,0
wikimedia_puppet,modules/role/manifests/analytics_new/hive/server.pp,1,1.0,1,0
wikimedia_puppet,modules/role/manifests/analytics_new/monitoring/disks.pp,1,1.0,1,0
wikimedia_puppet,modules/role/manifests/analytics_new/oozie/client.pp,1,1.0,1,0
wikimedia_puppet,modules/role/manifests/analytics_new/oozie/server.pp,1,1.0,1,0
wikimedia_puppet,modules/role/manifests/analytics_new/oozie/server/database.pp,1,1.0,1,0
wikimedia_puppet,modules/mediawiki/manifests/mwrepl.pp,2,0.5,2,0
wikimedia_puppet,manifests/role/yubiauth.pp,3,0.3333333333333333,3,0
wikimedia_puppet,modules/role/manifests/analytics_cluster/database/meta.pp,9,0.3333333333333333,6,3
wikimedia_puppet,modules/role/manifests/analytics_cluster/hadoop/client.pp,8,0.35714285714285715,4,4
wikimedia_puppet,modules/role/manifests/analytics_cluster/hadoop/ferm/namenode.pp,4,0.25,4,0
wikimedia_puppet,modules/role/manifests/analytics_cluster/hadoop/ferm/resourcemanager.pp,2,0.6666666666666666,2,0
wikimedia_puppet,modules/role/manifests/analytics_cluster/hadoop/master.pp,6,0.41379310344827586,4,2
wikimedia_puppet,modules/role/manifests/analytics_cluster/hadoop/standby.pp,7,0.45454545454545453,3,4
wikimedia_puppet,modules/role/manifests/analytics_cluster/hadoop/worker.pp,7,0.3409090909090909,4,3
wikimedia_puppet,modules/role/manifests/analytics_cluster/hive/client.pp,5,0.4444444444444444,5,0
wikimedia_puppet,modules/role/manifests/analytics_cluster/hive/metastore.pp,5,0.3,5,0
wikimedia_puppet,modules/role/manifests/analytics_cluster/hive/metastore/database.pp,4,0.25,4,0
wikimedia_puppet,modules/role/manifests/analytics_cluster/hive/server.pp,6,0.3,6,0
wikimedia_puppet,modules/role/manifests/analytics_cluster/monitoring/disks.pp,2,0.5,2,0
wikimedia_puppet,modules/role/manifests/analytics_cluster/oozie/client.pp,3,0.3333333333333333,3,0
wikimedia_puppet,modules/role/manifests/analytics_cluster/oozie/server.pp,6,0.3,6,0
wikimedia_puppet,modules/role/manifests/analytics_cluster/oozie/server/database.pp,3,0.5,3,0
wikimedia_puppet,modules/role/manifests/analytics_cluster/client.pp,4,0.38461538461538464,4,0
wikimedia_puppet,modules/role/manifests/analytics_cluster/hue.pp,8,0.26666666666666666,8,0
wikimedia_puppet,modules/mediawiki/manifests/packages/math.pp,2,0.75,2,0
wikimedia_puppet,modules/mediawiki/manifests/packages/tex.pp,3,0.5,3,0
wikimedia_puppet,modules/role/manifests/analytics_cluster/java.pp,4,0.4,4,0
wikimedia_puppet,modules/role/manifests/analytics_cluster/hadoop/logstash.pp,2,0.5,2,0
wikimedia_puppet,modules/base/manifests/puppet/common.pp,1,1.0,1,0
wikimedia_puppet,modules/role/manifests/parsoid/beta.pp,3,0.3333333333333333,3,0
wikimedia_puppet,modules/role/manifests/parsoid/common.pp,1,1.0,1,0
wikimedia_puppet,modules/role/manifests/parsoid/production.pp,1,1.0,1,0
wikimedia_puppet,modules/role/manifests/parsoid/testing.pp,6,0.5,6,0
wikimedia_puppet,modules/role/manifests/parsoid/rt_client.pp,5,0.3333333333333333,5,0
wikimedia_puppet,modules/role/manifests/parsoid/rt_server.pp,3,0.3333333333333333,3,0
wikimedia_puppet,modules/role/manifests/parsoid/vd_client.pp,3,0.6,3,0
wikimedia_puppet,modules/role/manifests/parsoid/vd_server.pp,4,0.4,4,0
wikimedia_puppet,modules/role/manifests/analytics_cluster/refinery.pp,4,0.3333333333333333,4,0
wikimedia_puppet,modules/role/manifests/analytics_cluster/refinery/camus.pp,4,0.5,4,0
wikimedia_puppet,modules/role/manifests/analytics_cluster/refinery/data/check.pp,4,0.25,4,0
wikimedia_puppet,modules/role/manifests/analytics_cluster/refinery/data/drop.pp,2,0.8333333333333334,2,0
wikimedia_puppet,modules/role/manifests/analytics_cluster/refinery/guard.pp,2,0.5,2,0
wikimedia_puppet,modules/role/manifests/analytics_cluster/refinery/source.pp,2,0.5,2,0
wikimedia_puppet,modules/role/manifests/analytics_cluster/rsyncd.pp,3,0.5,3,0
wikimedia_puppet,modules/role/manifests/analytics_cluster/users.pp,3,0.5,3,0
wikimedia_puppet,modules/role/manifests/analytics_cluster/hadoop/balancer.pp,4,0.5,4,0
wikimedia_puppet,modules/role/manifests/kafka/analytics/burrow.pp,4,0.25,4,0
wikimedia_puppet,modules/logrotate/manifests/conf.pp,1,1.0,1,0
wikimedia_puppet,modules/yubiauth/manifests/yhsm-daemon.pp,1,1.0,1,0
wikimedia_puppet,modules/role/manifests/yubiauth/server.pp,5,0.4,5,0
wikimedia_puppet,modules/yubiauth/manifests/yhsm_daemon.pp,3,0.5,3,0
wikimedia_puppet,modules/base/manifests/no_nfs_client.pp,1,1.0,1,0
wikimedia_puppet,modules/role/manifests/beta/availability_collector.pp,2,0.5,2,0
wikimedia_puppet,modules/role/manifests/beta/bastion.pp,1,1.0,1,0
wikimedia_puppet,modules/role/manifests/beta/puppetmaster.pp,2,0.5,2,0
wikimedia_puppet,modules/role/manifests/beta/trebuchet_testing.pp,3,0.3333333333333333,3,0
wikimedia_puppet,modules/role/manifests/beta/uploadservice.pp,1,1.0,1,0
wikimedia_puppet,modules/service/manifests/deploy/scap.pp,5,0.2,5,0
wikimedia_puppet,modules/service/manifests/deploy/trebuchet.pp,2,0.5,2,0
wikimedia_puppet,modules/role/manifests/swift/proxy.pp,4,0.5333333333333333,4,0
wikimedia_puppet,modules/role/manifests/swift/stats_reporter.pp,3,0.5,3,0
wikimedia_puppet,modules/role/manifests/swift/storage.pp,4,0.5714285714285714,4,0
wikimedia_puppet,modules/role/manifests/postgres/common.pp,5,0.25,5,0
wikimedia_puppet,modules/role/manifests/postgres/master.pp,3,0.5,3,0
wikimedia_puppet,modules/role/manifests/postgres/slave.pp,2,0.8,2,0
wikimedia_puppet,modules/role/manifests/otrs/webserver.pp,5,0.45454545454545453,5,0
wikimedia_puppet,manifests/role/xhgui.pp,5,0.38461538461538464,5,0
wikimedia_puppet,modules/role/manifests/lists/migration.pp,1,1.0,1,0
wikimedia_puppet,modules/role/manifests/lists/server.pp,8,0.2727272727272727,6,2
wikimedia_puppet,modules/aqs/manifests/init.pp,7,0.2222222222222222,7,0
wikimedia_puppet,modules/aqs/manifests/monitoring.pp,1,1.0,1,0
wikimedia_puppet,modules/role/manifests/wikimetrics/production.pp,2,0.5,2,0
wikimedia_puppet,modules/role/manifests/wikimetrics/staging.pp,2,0.5,2,0
wikimedia_puppet,modules/role/manifests/labs/tools/bastion.pp,1,1.0,1,0
wikimedia_puppet,modules/role/manifests/labs/tools/checker.pp,1,1.0,1,0
wikimedia_puppet,modules/role/manifests/labs/tools/common.pp,1,1.0,1,0
wikimedia_puppet,modules/role/manifests/labs/tools/compute.pp,1,1.0,1,0
wikimedia_puppet,modules/role/manifests/labs/tools/cronrunner.pp,1,1.0,1,0
wikimedia_puppet,modules/role/manifests/labs/tools/mailrelay.pp,1,1.0,1,0
wikimedia_puppet,modules/role/manifests/labs/tools/master.pp,1,1.0,1,0
wikimedia_puppet,modules/role/manifests/labs/tools/proxy.pp,2,0.5,2,0
wikimedia_puppet,modules/role/manifests/labs/tools/redis.pp,1,1.0,1,0
wikimedia_puppet,modules/role/manifests/labs/tools/services.pp,3,0.5,3,0
wikimedia_puppet,modules/role/manifests/labs/tools/shadow.pp,1,1.0,1,0
wikimedia_puppet,modules/role/manifests/labs/tools/static.pp,1,1.0,1,0
wikimedia_puppet,modules/role/manifests/labs/tools/submit.pp,1,1.0,1,0
wikimedia_puppet,modules/role/manifests/toollabs/docker/registry.pp,5,0.4166666666666667,5,0
wikimedia_puppet,modules/role/manifests/toollabs/elasticsearch.pp,7,0.2727272727272727,7,0
wikimedia_puppet,modules/role/manifests/toollabs/etcd/flannel.pp,5,0.5,5,0
wikimedia_puppet,modules/role/manifests/toollabs/etcd/k8s.pp,5,0.5,5,0
wikimedia_puppet,modules/role/manifests/toollabs/k8s/bastion.pp,7,0.5384615384615384,7,0
wikimedia_puppet,modules/role/manifests/toollabs/k8s/master.pp,9,0.48484848484848486,6,3
wikimedia_puppet,modules/role/manifests/toollabs/k8s/webproxy.pp,8,0.5,8,0
wikimedia_puppet,modules/role/manifests/toollabs/k8s/worker.pp,8,0.44,5,3
wikimedia_puppet,modules/role/manifests/toollabs/puppet/master.pp,1,1.0,1,0
wikimedia_puppet,modules/role/manifests/labs/quarry/celeryrunner.pp,5,0.2,5,0
wikimedia_puppet,modules/role/manifests/labs/quarry/database.pp,3,0.5,3,0
wikimedia_puppet,modules/role/manifests/labs/quarry/killer.pp,2,0.6666666666666666,2,0
wikimedia_puppet,modules/role/manifests/labs/quarry/redis.pp,3,0.5,3,0
wikimedia_puppet,modules/role/manifests/labs/quarry/web.pp,4,0.5714285714285714,4,0
wikimedia_puppet,modules/role/manifests/phabricator/config.pp,1,1.0,1,0
wikimedia_puppet,modules/role/manifests/phabricator/labs.pp,4,0.6666666666666666,4,0
wikimedia_puppet,modules/role/manifests/phabricator/main.pp,12,0.5576923076923077,5,7
wikimedia_puppet,modules/role/manifests/backup/config.pp,1,1.0,1,0
wikimedia_puppet,modules/role/manifests/backup/director.pp,8,0.29411764705882354,8,0
wikimedia_puppet,modules/role/manifests/backup/host.pp,1,1.0,1,0
wikimedia_puppet,modules/role/manifests/backup/storage.pp,1,1.0,1,0
wikimedia_puppet,modules/role/manifests/mail/mx.pp,6,0.4444444444444444,6,0
wikimedia_puppet,modules/role/manifests/mail/sender.pp,1,1.0,1,0
wikimedia_puppet,manifests/role/programdashboard.pp,1,1.0,1,0
wikimedia_puppet,modules/programdashboard/manifests/app.pp,1,1.0,1,0
wikimedia_puppet,modules/programdashboard/manifests/init.pp,1,1.0,1,0
wikimedia_puppet,modules/role/manifests/programdashboard/app.pp,3,0.3333333333333333,3,0
wikimedia_puppet,modules/labstore/manifests/traffic_shaping.pp,4,0.3333333333333333,4,0
wikimedia_puppet,modules/elasticsearch/spec/fixtures/manifests/site.pp,1,1.0,1,0
wikimedia_puppet,modules/standard/manifests/init.pp,12,0.2727272727272727,4,8
wikimedia_puppet,modules/standard/manifests/ntp.pp,4,0.4,4,0
wikimedia_puppet,modules/standard/manifests/ntp/client.pp,6,0.4166666666666667,6,0
wikimedia_puppet,modules/standard/manifests/diamond.pp,5,0.38461538461538464,5,0
wikimedia_puppet,modules/standard/manifests/mail/sender.pp,4,0.4,4,0
wikimedia_puppet,modules/toollabs/manifests/cnames.pp,1,1.0,1,0
wikimedia_puppet,modules/role/manifests/mediawiki/appserver.pp,6,0.3,6,0
wikimedia_puppet,modules/role/manifests/mediawiki/appserver/api.pp,6,0.25,6,0
wikimedia_puppet,modules/role/manifests/mediawiki/appserver/canary_api.pp,2,0.5,2,0
wikimedia_puppet,modules/role/manifests/mediawiki/canary_appserver.pp,3,0.3333333333333333,3,0
wikimedia_puppet,modules/role/manifests/mediawiki/common.pp,4,0.6153846153846154,4,0
wikimedia_puppet,modules/role/manifests/mediawiki/generic_monitoring.pp,1,1.0,1,0
wikimedia_puppet,modules/role/manifests/mediawiki/imagescaler.pp,4,0.6,4,0
wikimedia_puppet,modules/role/manifests/mediawiki/jobrunner.pp,7,0.29411764705882354,7,0
wikimedia_puppet,modules/role/manifests/mediawiki/maintenance.pp,7,0.35294117647058826,7,0
wikimedia_puppet,modules/role/manifests/mediawiki/scaler.pp,3,0.4,3,0
wikimedia_puppet,modules/role/manifests/mediawiki/videoscaler.pp,7,0.4,7,0
wikimedia_puppet,modules/role/manifests/mediawiki/webserver.pp,6,0.6818181818181818,2,4
wikimedia_puppet,modules/role/manifests/ci/jenkins_access.pp,1,1.0,1,0
wikimedia_puppet,modules/role/manifests/ci/master.pp,11,0.3541666666666667,5,6
wikimedia_puppet,modules/role/manifests/ci/publisher/labs.pp,2,0.6666666666666666,2,0
wikimedia_puppet,modules/role/manifests/ci/slave.pp,8,0.3157894736842105,8,0
wikimedia_puppet,modules/role/manifests/ci/slave/browsertests.pp,2,0.7777777777777778,2,0
wikimedia_puppet,modules/role/manifests/ci/slave/labs.pp,9,0.4,4,5
wikimedia_puppet,modules/role/manifests/ci/slave/labs/common.pp,3,0.625,3,0
wikimedia_puppet,modules/role/manifests/ci/slave/labs/light.pp,1,1.0,1,0
wikimedia_puppet,modules/role/manifests/ci/slave/localbrowser.pp,2,0.5,2,0
wikimedia_puppet,modules/role/manifests/ci/website.pp,2,0.5,2,0
wikimedia_puppet,modules/role/manifests/maps/master.pp,6,0.3939393939393939,6,0
wikimedia_puppet,modules/role/manifests/maps/server.pp,9,0.2,9,0
wikimedia_puppet,modules/role/manifests/maps/slave.pp,4,0.35714285714285715,4,0
wikimedia_puppet,modules/redis/manifests/multidc/ipsec.pp,3,0.3333333333333333,3,0
wikimedia_puppet,modules/yubiauth/manifests/yhsm_yubikey_ksm.pp,3,0.5,3,0
wikimedia_puppet,modules/role/manifests/cache/instances.pp,6,0.48484848484848486,4,2
wikimedia_puppet,modules/redis/manifests/multidc/instances.pp,1,1.0,1,0
wikimedia_puppet,modules/ferm/manifests/ipsec_allow.pp,3,0.3333333333333333,3,0
wikimedia_puppet,modules/role/manifests/bastionhost/2fa.pp,4,0.4,4,0
wikimedia_puppet,modules/role/manifests/labs/vagrant_lxc.pp,2,0.5,2,0
wikimedia_puppet,modules/dataset/manifests/cron/rsync/nginxlogs.pp,2,0.6666666666666666,2,0
wikimedia_puppet,modules/reportupdater/manifests/init.pp,1,1.0,1,0
wikimedia_puppet,modules/reportupdater/manifests/job.pp,4,0.4,4,0
wikimedia_puppet,modules/dataset/manifests/cron/wikitech_dumps.pp,3,0.5555555555555556,3,0
wikimedia_puppet,manifests/role/debug_proxy.pp,5,0.42857142857142855,5,0
wikimedia_puppet,modules/debug_proxy/manifests/init.pp,2,0.6666666666666666,2,0
wikimedia_puppet,modules/graphoid/manifests/packages.pp,2,0.5,2,0
wikimedia_puppet,modules/mathoid/manifests/packages.pp,1,1.0,1,0
wikimedia_puppet,modules/service/manifests/packages.pp,1,1.0,1,0
wikimedia_puppet,modules/icinga/manifests/monitor/paws.pp,1,1.0,1,0
wikimedia_puppet,modules/base/manifests/expose_puppet_certs.pp,4,0.42857142857142855,4,0
wikimedia_puppet,modules/openstack/manifests/envscripts.pp,2,0.5,2,0
wikimedia_puppet,modules/elasticsearch/manifests/https.pp,5,0.5,5,0
wikimedia_puppet,modules/mysql_wmf/manifests/mylvmbackup.pp,2,0.8571428571428571,2,0
wikimedia_puppet,modules/role/manifests/analytics_cluster/database/meta/backup.pp,2,0.6666666666666666,2,0
wikimedia_puppet,modules/role/manifests/analytics_cluster/database/meta/backup_dest.pp,4,0.42857142857142855,4,0
wikimedia_puppet,modules/role/manifests/microsites/annualreport.pp,2,0.5,2,0
wikimedia_puppet,modules/role/manifests/microsites/peopleweb.pp,3,0.5,3,0
wikimedia_puppet,modules/role/manifests/microsites/peopleweb/migration.pp,1,1.0,1,0
wikimedia_puppet,modules/role/manifests/microsites/releases.pp,2,0.75,2,0
wikimedia_puppet,modules/role/manifests/microsites/transparency.pp,4,0.25,4,0
wikimedia_puppet,modules/role/manifests/microsites/releases/upload.pp,1,1.0,1,0
wikimedia_puppet,modules/role/manifests/labs/ores/flower.pp,2,0.5,2,0
wikimedia_puppet,modules/role/manifests/labs/ores/lb.pp,3,0.5,3,0
wikimedia_puppet,modules/role/manifests/labs/ores/precached.pp,1,1.0,1,0
wikimedia_puppet,modules/role/manifests/labs/ores/redis.pp,2,0.5,2,0
wikimedia_puppet,modules/role/manifests/labs/ores/staging.pp,3,0.6666666666666666,3,0
wikimedia_puppet,modules/role/manifests/labs/ores/web.pp,3,0.5,3,0
wikimedia_puppet,modules/role/manifests/labs/ores/worker.pp,4,0.5,4,0
wikimedia_puppet,modules/role/manifests/gerrit/production.pp,5,0.5,5,0
wikimedia_puppet,modules/role/manifests/gerrit/production/replicationdest.pp,1,1.0,1,0
wikimedia_puppet,modules/base/manifests/syslogs/readable.pp,1,1.0,1,0
wikimedia_puppet,modules/ganglia/manifests/monitor/aggregator/site_instances.pp,3,0.3333333333333333,3,0
wikimedia_puppet,modules/mediawiki/manifests/maintenance/refreshlinks/cronjob.pp,1,1.0,1,0
wikimedia_puppet,modules/mediawiki/manifests/maintenance/updatequerypages/cronjob.pp,1,1.0,1,0
wikimedia_puppet,modules/mediawiki/manifests/maintenance/updatequerypages/enwiki/cronjob.pp,2,0.5,2,0
wikimedia_puppet,modules/role/manifests/labs/ores/compute.pp,1,1.0,1,0
wikimedia_puppet,modules/eventschemas/manifests/init.pp,1,1.0,1,0
wikimedia_puppet,modules/phabricator/manifests/deployment/source.pp,1,1.0,1,0
wikimedia_puppet,modules/phabricator/manifests/deployment/target.pp,1,1.0,1,0
wikimedia_puppet,modules/docker/manifests/engine.pp,4,0.5,4,0
wikimedia_puppet,modules/role/manifests/toollabs/docker/builder.pp,4,0.7058823529411765,4,0
wikimedia_puppet,modules/role/manifests/ores/redis.pp,1,1.0,1,0
wikimedia_puppet,modules/varnish/manifests/apt_preferences.pp,2,0.5,2,0
wikimedia_puppet,modules/docker/manifests/baseimages.pp,3,0.7692307692307693,3,0
wikimedia_puppet,manifests/role/changeprop.pp,4,0.25,4,0
wikimedia_puppet,modules/changeprop/manifests/init.pp,10,0.2916666666666667,4,6
wikimedia_puppet,modules/changeprop/tests/init.pp,1,1.0,1,0
wikimedia_puppet,modules/role/manifests/labs/ores/redisproxy.pp,1,1.0,1,0
wikimedia_puppet,modules/toollabs/manifests/kubebuilder.pp,4,0.6,4,0
wikimedia_puppet,modules/eventlogging/manifests/server.pp,3,0.5714285714285714,3,0
wikimedia_puppet,modules/snapshot/manifests/dumps/dirs.pp,2,0.6111111111111112,2,0
wikimedia_puppet,modules/snapshot/manifests/deployment/common.pp,1,1.0,1,0
wikimedia_puppet,modules/snapshot/manifests/cron/centralauthdump.pp,2,0.6666666666666666,2,0
wikimedia_puppet,modules/snapshot/manifests/cron/cirrussearch.pp,3,0.5833333333333334,3,0
wikimedia_puppet,modules/snapshot/manifests/cron/mediaperprojectlists.pp,3,0.5555555555555556,3,0
wikimedia_puppet,modules/snapshot/manifests/cron/wikidatadumps/common.pp,2,0.6,2,0
wikimedia_puppet,modules/snapshot/manifests/cron/wikidatadumps/json.pp,3,0.6,3,0
wikimedia_puppet,modules/snapshot/manifests/cron/wikidatadumps/ttl.pp,4,0.42857142857142855,4,0
wikimedia_puppet,modules/snapshot/manifests/cron/wikiqueryskip.pp,1,1.0,1,0
wikimedia_puppet,modules/snapshot/manifests/cron/dumplists.pp,3,0.6666666666666666,3,0
wikimedia_puppet,modules/snapshot/manifests/cron/mediadirlists.pp,2,0.6666666666666666,2,0
wikimedia_puppet,modules/snapshot/manifests/cron/pagetitles.pp,2,0.75,2,0
wikimedia_puppet,modules/snapshot/manifests/deployment/dirs.pp,2,0.6666666666666666,2,0
wikimedia_puppet,modules/snapshot/manifests/deployment/source.pp,2,0.5,2,0
wikimedia_puppet,modules/role/manifests/snapshot/deployment.pp,2,0.5,2,0
wikimedia_puppet,modules/role/manifests/snapshot/dumper.pp,5,0.5384615384615384,5,0
wikimedia_puppet,modules/netops/manifests/init.pp,1,1.0,1,0
wikimedia_puppet,modules/netops/manifests/monitoring.pp,6,0.3939393939393939,5,1
wikimedia_puppet,modules/netops/manifests/check.pp,4,0.6363636363636364,4,0
wikimedia_puppet,modules/snapshot/manifests/dumps/packages.pp,2,0.5714285714285714,2,0
wikimedia_puppet,modules/role/manifests/snapshot/cron.pp,1,1.0,1,0
wikimedia_puppet,modules/scap/manifests/server.pp,4,0.25,4,0
wikimedia_puppet,modules/eventlogging/manifests/deployment/target.pp,4,0.4,4,0
wikimedia_puppet,modules/scap/manifests/source.pp,5,0.5,5,0
wikimedia_puppet,modules/eventlogging/manifests/dependencies.pp,4,0.5555555555555556,4,0
wikimedia_puppet,modules/role/manifests/eventlogging/analytics.pp,5,0.42857142857142855,5,0
wikimedia_puppet,modules/mediawiki/manifests/packages/legacy.pp,2,0.6666666666666666,2,0
wikimedia_puppet,modules/nagios_common/manifests/check/redis.pp,2,0.5,2,0
wikimedia_puppet,modules/redis/manifests/monitoring/instance.pp,4,0.4666666666666667,4,0
wikimedia_puppet,modules/icinga/manifests/monitor/git.pp,1,1.0,1,0
wikimedia_puppet,modules/role/manifests/bastionhost/migration.pp,3,0.6666666666666666,3,0
wikimedia_puppet,modules/toollabs/manifests/legacy/fonts.pp,2,0.6666666666666666,2,0
wikimedia_puppet,modules/ifttt/manifests/base.pp,1,1.0,1,0
wikimedia_puppet,modules/ifttt/manifests/web.pp,4,0.3333333333333333,4,0
wikimedia_puppet,modules/role/manifests/ifttt/production.pp,1,1.0,1,0
wikimedia_puppet,modules/role/manifests/ifttt/staging.pp,1,1.0,1,0
wikimedia_puppet,modules/base/manifests/initramfs.pp,1,1.0,1,0
wikimedia_puppet,modules/initramfs/manifests/hook.pp,1,1.0,1,0
wikimedia_puppet,modules/initramfs/manifests/init.pp,1,1.0,1,0
wikimedia_puppet,modules/initramfs/manifests/script.pp,1,1.0,1,0
wikimedia_puppet,modules/debdeploy/manifests/master.pp,1,1.0,1,0
wikimedia_puppet,modules/lshell/manifests/init.pp,3,0.3333333333333333,3,0
wikimedia_puppet,modules/yubiauth/manifests/yhsm_aead_sync.pp,1,1.0,1,0
wikimedia_puppet,modules/cgred/manifests/group.pp,2,0.6666666666666666,2,0
wikimedia_puppet,modules/cgred/manifests/init.pp,3,0.4,3,0
wikimedia_puppet,modules/role/manifests/installserver/tftp_server.pp,3,0.3333333333333333,3,0
wikimedia_puppet,modules/letsencrypt/manifests/init.pp,3,0.6,3,0
wikimedia_puppet,modules/letsencrypt/manifests/cert/integrated.pp,2,0.6,2,0
wikimedia_puppet,modules/role/manifests/ci/castor/server.pp,4,0.4,4,0
wikimedia_puppet,modules/contint/manifests/composer.pp,2,0.5,2,0
wikimedia_puppet,modules/contint/manifests/deployment_dir.pp,2,0.5,2,0
wikimedia_puppet,modules/contint/manifests/phpunit.pp,2,0.5,2,0
wikimedia_puppet,modules/role/manifests/planet/venus.pp,3,0.6,3,0
wikimedia_puppet,modules/ganglia/manifests/monitor/decommission.pp,2,0.8571428571428571,2,0
wikimedia_puppet,modules/icinga/manifests/monitor/stream.pp,1,1.0,1,0
wikimedia_puppet,modules/role/manifests/requesttracker/labs.pp,2,0.5,2,0
wikimedia_puppet,modules/role/manifests/requesttracker/server.pp,5,0.5,5,0
wikimedia_puppet,modules/role/manifests/racktables/server.pp,4,0.2857142857142857,4,0
wikimedia_puppet,modules/contint/manifests/php.pp,2,0.6666666666666666,2,0
wikimedia_puppet,modules/role/manifests/test/system.pp,3,0.6,3,0
wikimedia_puppet,modules/role/manifests/phragile/labs.pp,2,0.5,2,0
wikimedia_puppet,modules/contint/manifests/npmtravis.pp,2,0.5,2,0
wikimedia_puppet,modules/imagemagick/manifests/install.pp,3,0.5,3,0
wikimedia_puppet,modules/statistics/manifests/sites/analytics.pp,3,0.6,3,0
wikimedia_puppet,modules/confluent/manifests/kafka/broker.pp,5,0.5909090909090909,3,2
wikimedia_puppet,modules/confluent/manifests/kafka/broker/alerts.pp,4,0.42857142857142855,4,0
wikimedia_puppet,modules/confluent/manifests/kafka/broker/jmxtrans.pp,2,0.6666666666666666,2,0
wikimedia_puppet,modules/confluent/manifests/kafka/client.pp,2,0.75,2,0
wikimedia_puppet,modules/role/manifests/labs/redirector.pp,2,0.5,2,0
wikimedia_puppet,modules/diamond/manifests/collector/nagios.pp,2,0.6666666666666666,2,0
wikimedia_puppet,modules/graphite/manifests/carbon_cache_instance.pp,1,1.0,1,0
wikimedia_puppet,modules/role/manifests/piwik/server.pp,6,0.3,6,0
wikimedia_puppet,modules/role/manifests/performance/site.pp,4,0.42857142857142855,4,0
wikimedia_puppet,modules/role/manifests/noc/site.pp,4,0.5,4,0
wikimedia_puppet,modules/icinga/manifests/monitor/toollabs.pp,9,0.22727272727272727,5,4
wikimedia_puppet,modules/contint/manifests/package_builder.pp,3,0.7142857142857143,3,0
wikimedia_puppet,modules/contint/manifests/packages/php.pp,9,0.39285714285714285,6,3
wikimedia_puppet,modules/role/manifests/notebook/server.pp,2,0.5,2,0
wikimedia_puppet,modules/lvs/manifests/monitor_services.pp,6,0.3,6,0
wikimedia_puppet,modules/mirrors/manifests/tails.pp,1,1.0,1,0
wikimedia_puppet,modules/scap/manifests/clean.pp,2,0.5,2,0
wikimedia_puppet,modules/service/manifests/uwsgi.pp,9,0.5652173913043478,3,6
wikimedia_puppet,modules/varnish/manifests/logging/xcache.pp,5,0.5833333333333334,5,0
wikimedia_puppet,modules/role/manifests/labs/nfsclient.pp,6,0.35135135135135137,5,1
wikimedia_puppet,modules/role/manifests/requesttracker/upgradetest.pp,2,0.6,2,0
wikimedia_puppet,modules/role/manifests/labs/nfs/misc.pp,6,0.4666666666666667,6,0
wikimedia_puppet,modules/labstore/manifests/nfs_mount.pp,7,0.5789473684210527,7,0
wikimedia_puppet,modules/labstore/manifests/backup_keys.pp,3,0.5,3,0
wikimedia_puppet,modules/labstore/manifests/fileserver/primary.pp,3,0.5,3,0
wikimedia_puppet,modules/labstore/manifests/monitoring/interfaces.pp,7,0.2222222222222222,7,0
wikimedia_puppet,modules/labstore/manifests/monitoring/ldap.pp,3,0.5,3,0
wikimedia_puppet,modules/labstore/manifests/monitoring/nfsd.pp,1,1.0,1,0
wikimedia_puppet,modules/role/manifests/labs/nfs/backup.pp,2,0.5,2,0
wikimedia_puppet,modules/role/manifests/labs/nfs/primary.pp,2,0.75,2,0
wikimedia_puppet,modules/icinga/manifests/monitor/commons.pp,1,1.0,1,0
wikimedia_puppet,modules/role/manifests/installserver/mirrors.pp,2,0.5,2,0
wikimedia_puppet,modules/role/manifests/snapshot/common.pp,5,0.3,5,0
wikimedia_puppet,modules/role/manifests/snapshot/cron/primary.pp,3,0.5555555555555556,3,0
wikimedia_puppet,modules/role/manifests/snapshot/cron/secondary.pp,3,0.625,3,0
wikimedia_puppet,modules/role/manifests/snapshot/dumps/hugewikis.pp,1,1.0,1,0
wikimedia_puppet,modules/role/manifests/snapshot/dumps/monitor.pp,1,1.0,1,0
wikimedia_puppet,modules/role/manifests/snapshot/dumps/regularwikis.pp,1,1.0,1,0
wikimedia_puppet,modules/role/manifests/snapshot/producer.pp,1,1.0,1,0
wikimedia_puppet,modules/role/manifests/syslog/centralserver.pp,6,0.375,6,0
wikimedia_puppet,modules/druid/manifests/broker.pp,3,0.4,3,0
wikimedia_puppet,modules/druid/manifests/cdh/hadoop/dependencies.pp,3,0.5,3,0
wikimedia_puppet,modules/druid/manifests/cdh/hadoop/setup.pp,1,1.0,1,0
wikimedia_puppet,modules/druid/manifests/coordinator.pp,4,0.3333333333333333,4,0
wikimedia_puppet,modules/druid/manifests/historical.pp,3,0.3333333333333333,3,0
wikimedia_puppet,modules/druid/manifests/init.pp,4,0.4444444444444444,4,0
wikimedia_puppet,modules/druid/manifests/middlemanager.pp,4,0.3333333333333333,4,0
wikimedia_puppet,modules/druid/manifests/overlord.pp,3,0.4,3,0
wikimedia_puppet,modules/druid/manifests/service.pp,3,0.6,3,0
wikimedia_puppet,modules/role/manifests/analytics_cluster/druid/common.pp,4,0.4,4,0
wikimedia_puppet,modules/role/manifests/analytics_cluster/druid/hadoop.pp,3,0.3333333333333333,3,0
wikimedia_puppet,modules/role/manifests/analytics_cluster/druid/worker.pp,5,0.2857142857142857,5,0
wikimedia_puppet,modules/nagios_common/manifests/check_command/config.pp,1,1.0,1,0
wikimedia_puppet,modules/mediawiki/manifests/firejail.pp,1,1.0,1,0
wikimedia_puppet,modules/raid/manifests/init.pp,9,0.38461538461538464,5,4
wikimedia_puppet,modules/backup/manifests/openldapset.pp,2,0.6666666666666666,2,0
wikimedia_puppet,modules/network/manifests/constants.pp,25,0.17894736842105263,7,18
wikimedia_puppet,modules/role/manifests/ores/web.pp,3,0.5,3,0
wikimedia_puppet,modules/role/manifests/ores/worker.pp,3,0.3333333333333333,3,0
wikimedia_puppet,modules/labstore/manifests/fileserver/secondary.pp,5,0.3333333333333333,5,0
wikimedia_puppet,modules/role/manifests/labs/nfs/secondary.pp,10,0.32075471698113206,6,4
wikimedia_puppet,modules/aptrepo/manifests/distribution.pp,1,1.0,1,0
wikimedia_puppet,modules/aptrepo/manifests/init.pp,6,0.4444444444444444,6,0
wikimedia_puppet,modules/role/manifests/aptrepo/wikimedia.pp,3,0.7777777777777778,3,0
wikimedia_puppet,modules/endowment/manifests/init.pp,2,0.75,2,0
wikimedia_puppet,modules/role/manifests/microsites/endowment.pp,1,1.0,1,0
wikimedia_puppet,modules/varnish/manifests/netmapper_update_common.pp,1,1.0,1,0
wikimedia_puppet,modules/varnish/manifests/wikimedia_vcl.pp,5,0.6,5,0
wikimedia_puppet,modules/role/manifests/toollabs/merlbot_proxy.pp,1,1.0,1,0
wikimedia_puppet,modules/contint/manifests/packages/analytics.pp,3,0.5,3,0
wikimedia_puppet,modules/contint/manifests/packages/java.pp,3,0.5,3,0
wikimedia_puppet,modules/contint/manifests/master_dir.pp,2,0.5,2,0
wikimedia_puppet,modules/role/manifests/maps/postgresql_common.pp,1,1.0,1,0
wikimedia_puppet,modules/labspuppetbackend/manifests/init.pp,4,0.5,4,0
wikimedia_puppet,modules/prometheus/manifests/scripts.pp,1,1.0,1,0
wikimedia_puppet,modules/prometheus/manifests/server.pp,5,0.7,5,0
wikimedia_puppet,modules/role/manifests/prometheus/labs_project.pp,2,0.5,2,0
wikimedia_puppet,modules/systemd/manifests/sidekick.pp,3,0.3333333333333333,3,0
wikimedia_puppet,modules/cassandra/manifests/instance/monitoring.pp,5,0.5,5,0
wikimedia_puppet,modules/diamond/manifests/collector/nagios_lib.pp,1,1.0,1,0
wikimedia_puppet,modules/diamond/manifests/collector/servicestats_lib.pp,1,1.0,1,0
wikimedia_puppet,modules/openstack/manifests/nova/instancersync.pp,1,1.0,1,0
wikimedia_puppet,modules/contint/manifests/arcanist.pp,1,1.0,1,0
wikimedia_puppet,modules/prometheus/manifests/web.pp,4,0.42857142857142855,4,0
wikimedia_puppet,modules/role/manifests/prometheus/ops.pp,17,0.4247787610619469,5,12
wikimedia_puppet,modules/role/manifests/security/tools.pp,1,1.0,1,0
wikimedia_puppet,modules/etcd/manifests/backup.pp,1,1.0,1,0
wikimedia_puppet,modules/prometheus/manifests/init.pp,2,0.6666666666666666,2,0
wikimedia_puppet,modules/gerrit/manifests/init.pp,6,0.6,6,0
wikimedia_puppet,modules/ganglia/manifests/views/analytics_data.pp,1,1.0,1,0
wikimedia_puppet,modules/ganglia/manifests/views/dns.pp,2,0.5,2,0
wikimedia_puppet,modules/ganglia/manifests/views/hadoop.pp,2,0.5,2,0
wikimedia_puppet,modules/ganglia/manifests/views/kafkatee.pp,1,1.0,1,0
wikimedia_puppet,modules/ganglia/manifests/views/varnishkafka.pp,1,1.0,1,0
wikimedia_puppet,modules/role/manifests/ganglia/views.pp,2,0.5,2,0
wikimedia_puppet,manifests/role/pybaltest.pp,2,0.5,2,0
wikimedia_puppet,modules/role/manifests/gerrit/server.pp,6,0.5,4,2
wikimedia_puppet,modules/icinga/manifests/monitor/ores_labs_web_node.pp,1,1.0,1,0
wikimedia_puppet,modules/role/manifests/prometheus/tools.pp,7,0.29411764705882354,7,0
wikimedia_puppet,modules/toollabs/manifests/maintain_kubeusers.pp,5,0.3333333333333333,5,0
wikimedia_puppet,modules/gerrit/manifests/migration/destination.pp,3,0.3333333333333333,3,0
wikimedia_puppet,modules/gerrit/manifests/migration/source.pp,2,0.6666666666666666,2,0
wikimedia_puppet,modules/contint/manifests/packages/androidsdk.pp,2,0.6,2,0
wikimedia_puppet,modules/statistics/manifests/wmde.pp,8,0.375,5,3
wikimedia_puppet,modules/role/manifests/iegreview/app.pp,2,0.6,2,0
wikimedia_puppet,modules/role/manifests/wikistats/instance.pp,3,0.5,3,0
wikimedia_puppet,modules/role/manifests/ipv6/relay.pp,1,1.0,1,0
wikimedia_puppet,modules/role/manifests/spare/system.pp,4,0.42857142857142855,4,0
wikimedia_puppet,modules/role/manifests/rancid/server.pp,2,0.8,2,0
wikimedia_puppet,modules/prometheus/manifests/node_exporter.pp,10,0.3157894736842105,10,0
wikimedia_puppet,modules/role/manifests/prometheus/node_exporter.pp,4,0.45454545454545453,4,0
wikimedia_puppet,modules/puppetmaster/manifests/gitprivate.pp,3,0.7142857142857143,3,0
wikimedia_puppet,modules/grub/manifests/bootparam.pp,3,0.3333333333333333,3,0
wikimedia_puppet,modules/grub/manifests/defaults.pp,2,0.5,2,0
wikimedia_puppet,modules/grub/manifests/init.pp,1,1.0,1,0
wikimedia_puppet,modules/puppetmaster/manifests/web_test.pp,1,1.0,1,0
wikimedia_puppet,modules/role/manifests/parsoid/transition_cleanup.pp,1,1.0,1,0
wikimedia_puppet,modules/parsoid/manifests/init.pp,5,0.6666666666666666,5,0
wikimedia_puppet,modules/role/manifests/osmium/migration.pp,2,0.6666666666666666,2,0
wikimedia_puppet,modules/mediawiki/manifests/conftool.pp,3,0.6,3,0
wikimedia_puppet,modules/role/manifests/grafana/production.pp,2,0.5,2,0
wikimedia_puppet,modules/role/manifests/grafana/base.pp,7,0.25,7,0
wikimedia_puppet,modules/role/manifests/grafana/labs.pp,5,0.42857142857142855,5,0
wikimedia_puppet,modules/role/manifests/snapshot/monitor.pp,3,0.6,3,0
wikimedia_puppet,modules/service/manifests/deploy/common.pp,1,1.0,1,0
wikimedia_puppet,modules/service/manifests/deploy/gitclone.pp,2,0.5,2,0
wikimedia_puppet,modules/role/manifests/snapshot/cronjobs.pp,2,0.7142857142857143,2,0
wikimedia_puppet,modules/role/manifests/snapshot/cronrunner.pp,2,0.8333333333333334,2,0
wikimedia_puppet,modules/toollabs/manifests/images.pp,4,0.4,4,0
wikimedia_puppet,modules/ldap/manifests/management.pp,3,0.6666666666666666,3,0
wikimedia_puppet,modules/role/manifests/openldap/management.pp,6,0.36363636363636365,6,0
wikimedia_puppet,modules/role/manifests/labs/db/replica.pp,7,0.5151515151515151,3,4
wikimedia_puppet,modules/role/manifests/servermon/wmf.pp,3,0.7142857142857143,3,0
wikimedia_puppet,modules/snapshot/manifests/cron.pp,2,0.7058823529411765,2,0
wikimedia_puppet,modules/role/manifests/restbase/rsync/cerium.pp,1,1.0,1,0
wikimedia_puppet,modules/role/manifests/restbase/rsync/praseodymium.pp,1,1.0,1,0
wikimedia_puppet,modules/role/manifests/restbase/rsync/xenon.pp,1,1.0,1,0
wikimedia_puppet,modules/html5depurate/manifests/init.pp,1,1.0,1,0
wikimedia_puppet,modules/role/manifests/html5depurate/server.pp,2,0.5,2,0
wikimedia_puppet,modules/systemd/manifests/syslog.pp,3,0.6,3,0
wikimedia_puppet,modules/role/manifests/etherpad/server.pp,2,0.6666666666666666,2,0
wikimedia_puppet,modules/role/manifests/toollabs/logreceiver.pp,1,1.0,1,0
wikimedia_puppet,modules/html5depurate/manifests/monitoring.pp,1,1.0,1,0
wikimedia_puppet,modules/role/manifests/ipmi/mgmt.pp,2,0.6666666666666666,2,0
wikimedia_puppet,modules/role/manifests/toollabs/logging/centralserver.pp,4,0.42857142857142855,4,0
wikimedia_puppet,modules/k8s/manifests/sendlogs.pp,1,1.0,1,0
wikimedia_puppet,modules/statsd_proxy/manifests/init.pp,3,0.5,3,0
wikimedia_puppet,modules/statistics/manifests/wmde_user.pp,1,1.0,1,0
wikimedia_puppet,modules/statistics/manifests/wmde/user.pp,1,1.0,1,0
wikimedia_puppet,modules/prometheus/manifests/mysqld_exporter.pp,3,0.42857142857142855,3,0
wikimedia_puppet,modules/role/manifests/prometheus/mysqld_exporter.pp,3,0.6,3,0
wikimedia_puppet,modules/role/manifests/dataset/common.pp,4,0.25,4,0
wikimedia_puppet,modules/monitoring/manifests/icinga/bad_directory_owner.pp,2,0.5,2,0
wikimedia_puppet,modules/role/manifests/labsdb/manager.pp,1,1.0,1,0
wikimedia_puppet,modules/role/manifests/thumbor/mediawiki.pp,7,0.6666666666666666,2,5
wikimedia_puppet,modules/thumbor/manifests/init.pp,2,0.8125,2,0
wikimedia_puppet,modules/thumbor/manifests/instance.pp,1,1.0,1,0
wikimedia_puppet,modules/thumbor/manifests/swift.pp,4,0.7,4,0
wikimedia_puppet,modules/snapshot/manifests/cron/contentxlation.pp,3,0.7,3,0
wikimedia_puppet,modules/role/manifests/labs/dns_floating_ip_updater.pp,4,0.3333333333333333,4,0
wikimedia_puppet,modules/openstack/manifests/nova/spiceproxy.pp,4,0.4166666666666667,4,0
wikimedia_puppet,modules/cassandra/manifests/sysctl.pp,1,1.0,1,0
wikimedia_puppet,modules/role/manifests/toollabs/logging/sender.pp,2,0.75,2,0
wikimedia_puppet,modules/dataset/manifests/rsync/pagecounts_ez.pp,2,0.5,2,0
wikimedia_puppet,modules/puppetmaster/manifests/labsrootpass.pp,1,1.0,1,0
wikimedia_puppet,modules/role/manifests/toollabs/etcd/expose_metrics.pp,2,0.5,2,0
wikimedia_puppet,modules/prometheus/manifests/blackbox_exporter.pp,3,0.3333333333333333,3,0
wikimedia_puppet,modules/role/manifests/prometheus/blackbox_exporter.pp,1,1.0,1,0
wikimedia_puppet,modules/puppetmaster/manifests/puppetdb.pp,6,0.4666666666666667,6,0
wikimedia_puppet,modules/puppetmaster/manifests/puppetdb/config.pp,1,1.0,1,0
wikimedia_puppet,modules/puppetmaster/manifests/puppetdb/database.pp,6,0.4166666666666667,6,0
wikimedia_puppet,modules/role/manifests/puppetmaster/puppetdb.pp,9,0.2692307692307692,4,5
wikimedia_puppet,modules/role/manifests/analytics_cluster/mysql_password.pp,5,0.3333333333333333,5,0
wikimedia_puppet,modules/confluent/manifests/kafka/mirror/alerts.pp,3,0.4,3,0
wikimedia_puppet,modules/confluent/manifests/kafka/mirror/instance.pp,5,0.6428571428571429,5,0
wikimedia_puppet,modules/confluent/manifests/kafka/mirror/jmxtrans.pp,2,0.6,2,0
wikimedia_puppet,modules/confluent/manifests/kafka/mirrors.pp,1,1.0,1,0
wikimedia_puppet,modules/puppetdbquery/examples/nova_functions.pp,1,1.0,1,0
wikimedia_puppet,modules/puppetdbquery/examples/query_node_examples.pp,1,1.0,1,0
wikimedia_puppet,modules/puppetdbquery/examples/query_resource_examples.pp,1,1.0,1,0
wikimedia_puppet,modules/deployment/manifests/umask_wikidev.pp,1,1.0,1,0
wikimedia_puppet,modules/role/manifests/kafka/main/mirror.pp,3,0.6666666666666666,3,0
wikimedia_puppet,modules/logstash/manifests/input/log4j.pp,2,0.5,2,0
wikimedia_puppet,modules/scap/manifests/conftool.pp,1,1.0,1,0
wikimedia_puppet,modules/labstore/manifests/drbd/node.pp,1,1.0,1,0
wikimedia_puppet,modules/labstore/manifests/drbd/resource.pp,3,0.7142857142857143,3,0
wikimedia_puppet,modules/role/manifests/installserver/dhcp.pp,2,0.7142857142857143,2,0
wikimedia_puppet,modules/scap/manifests/dsh/group.pp,2,0.8,2,0
wikimedia_puppet,modules/changeprop/manifests/packages.pp,1,1.0,1,0
wikimedia_puppet,modules/role/manifests/striker/web.pp,6,0.25,6,0
wikimedia_puppet,modules/striker/manifests/build.pp,4,0.4,4,0
wikimedia_puppet,modules/striker/manifests/nginx.pp,2,0.5,2,0
wikimedia_puppet,modules/striker/manifests/uwsgi.pp,6,0.36363636363636365,6,0
wikimedia_puppet,modules/striker/manifests/apache.pp,2,0.5,2,0
wikimedia_puppet,modules/puppetmaster/manifests/web_frontend.pp,5,0.5,5,0
wikimedia_puppet,modules/clush/manifests/master.pp,4,0.4,4,0
wikimedia_puppet,modules/clush/manifests/target.pp,1,1.0,1,0
wikimedia_puppet,modules/role/manifests/toollabs/clush/master.pp,7,0.23076923076923078,7,0
wikimedia_puppet,modules/role/manifests/toollabs/clush/target.pp,2,0.5,2,0
wikimedia_puppet,modules/openstack/manifests/horizon/puppetpanel.pp,4,0.5,4,0
wikimedia_puppet,modules/icinga/manifests/monitor/elasticsearch.pp,1,1.0,1,0
wikimedia_puppet,modules/role/manifests/archiva/migration.pp,1,1.0,1,0
wikimedia_puppet,modules/role/manifests/elasticsearch/cirrus.pp,4,0.6666666666666666,4,0
wikimedia_puppet,modules/role/manifests/elasticsearch/common.pp,4,0.4166666666666667,4,0
wikimedia_puppet,modules/role/manifests/elasticsearch/relforge.pp,5,0.5333333333333333,5,0
wikimedia_puppet,modules/statistics/manifests/discovery.pp,4,0.3684210526315789,4,0
wikimedia_puppet,modules/role/manifests/aptly/client.pp,2,0.6666666666666666,2,0
wikimedia_puppet,modules/role/manifests/aptly/server.pp,2,0.5,2,0
wikimedia_puppet,modules/role/manifests/bastionhost/twofa.pp,4,0.4,4,0
wikimedia_puppet,modules/puppetmaster/manifests/puppetdb/client.pp,4,0.5714285714285714,4,0
wikimedia_puppet,modules/role/manifests/puppetmaster/common.pp,2,0.6,2,0
wikimedia_puppet,modules/external_proxy/manifests/instance.pp,3,0.3333333333333333,3,0
wikimedia_puppet,modules/role/manifests/google_api_proxy.pp,1,1.0,1,0
wikimedia_puppet,modules/statistics/manifests/sites/yarn.pp,2,0.6,2,0
wikimedia_puppet,modules/role/manifests/labs/google_api_proxy.pp,2,0.5,2,0
wikimedia_puppet,manifests/role/mirrors.pp,2,0.5,2,0
wikimedia_puppet,modules/labstore/manifests/monitoring/exports.pp,2,0.6666666666666666,2,0
wikimedia_puppet,modules/ldap/manifests/yamlcreds.pp,3,0.3333333333333333,3,0
wikimedia_puppet,modules/statistics/manifests/sites/pivot.pp,4,0.4,4,0
wikimedia_puppet,modules/puppetmaster/manifests/rsync.pp,1,1.0,1,0
wikimedia_puppet,modules/phabricator/manifests/bot.pp,1,1.0,1,0
wikimedia_puppet,modules/salt/manifests/orchestration.pp,2,0.8,2,0
wikimedia_puppet,modules/role/manifests/ircyall/init.pp,1,1.0,1,0
wikimedia_puppet,modules/role/manifests/deprecated/mediawiki/install.pp,3,0.5,3,0
wikimedia_puppet,modules/monitoring/manifests/check_prometheus.pp,5,0.5,5,0
wikimedia_puppet,modules/postgresql/manifests/packages.pp,3,0.3333333333333333,3,0
wikimedia_puppet,modules/postgresql/manifests/dirs.pp,3,0.5,3,0
wikimedia_puppet,modules/role/manifests/ci/slave/android.pp,3,0.5,3,0
wikimedia_puppet,modules/salt/manifests/monitoring.pp,1,1.0,1,0
wikimedia_puppet,modules/role/manifests/puppetmaster/standalone.pp,11,0.2608695652173913,5,6
wikimedia_puppet,modules/role/manifests/analytics_cluster/hive/site_hdfs.pp,1,1.0,1,0
wikimedia_puppet,modules/role/manifests/poolcounter/server.pp,4,0.5,4,0
wikimedia_puppet,modules/role/manifests/prometheus/beta.pp,4,0.625,4,0
wikimedia_puppet,modules/role/manifests/beta/mediawiki.pp,6,0.2857142857142857,6,0
wikimedia_puppet,modules/role/manifests/beta/deploymentserver.pp,3,0.5,3,0
wikimedia_puppet,modules/role/manifests/toollabs/legacy.pp,2,0.6666666666666666,2,0
wikimedia_puppet,modules/role/manifests/labs/bootstrapvz.pp,2,0.5,2,0
wikimedia_puppet,modules/role/manifests/wikidata/builder.pp,2,0.5,2,0
wikimedia_puppet,modules/role/manifests/labs/sentry.pp,1,1.0,1,0
wikimedia_puppet,modules/ldap/manifests/role/client/labs.pp,2,0.5,2,0
wikimedia_puppet,modules/ldap/manifests/role/config/labs.pp,2,0.6666666666666666,2,0
wikimedia_puppet,modules/quarry/manifests/base.pp,3,0.3333333333333333,3,0
wikimedia_puppet,modules/quarry/manifests/database.pp,2,0.5,2,0
wikimedia_puppet,modules/quarry/manifests/querykiller.pp,2,0.5,2,0
wikimedia_puppet,modules/quarry/manifests/redis.pp,2,0.5,2,0
wikimedia_puppet,modules/cassandra/manifests/twcs.pp,1,1.0,1,0
wikimedia_puppet,modules/prometheus/manifests/varnish_exporter.pp,2,0.6666666666666666,2,0
wikimedia_puppet,modules/role/manifests/prometheus/varnish_exporter.pp,2,0.75,2,0
wikimedia_puppet,modules/role/manifests/etcd/common.pp,4,0.5,4,0
wikimedia_puppet,modules/role/manifests/etcd/kubernetes.pp,2,0.5,2,0
wikimedia_puppet,modules/role/manifests/etcd/networking.pp,2,0.6666666666666666,2,0
wikimedia_puppet,modules/role/manifests/gerrit/migration.pp,2,0.5,2,0
wikimedia_puppet,modules/pivot/manifests/init.pp,4,0.375,4,0
wikimedia_puppet,modules/role/manifests/analytics_cluster/druid/pivot.pp,1,1.0,1,0
wikimedia_puppet,modules/role/manifests/labsdb/init.pp,1,1.0,1,0
wikimedia_puppet,modules/role/manifests/labsdb/views.pp,1,1.0,1,0
wikimedia_puppet,modules/role/manifests/authdns/data.pp,4,0.375,4,0
wikimedia_puppet,modules/role/manifests/authdns/monitoring.pp,1,1.0,1,0
wikimedia_puppet,modules/role/manifests/authdns/server.pp,6,0.35714285714285715,6,0
wikimedia_puppet,modules/role/manifests/authdns/testns.pp,3,0.5,3,0
wikimedia_puppet,modules/role/manifests/puppet/self.pp,3,0.5,3,0
wikimedia_puppet,modules/role/manifests/statistics/base.pp,2,0.6666666666666666,2,0
wikimedia_puppet,modules/role/manifests/statistics/cruncher.pp,9,0.43478260869565216,4,5
wikimedia_puppet,modules/role/manifests/statistics/migration.pp,1,1.0,1,0
wikimedia_puppet,modules/role/manifests/statistics/private.pp,8,0.35,8,0
wikimedia_puppet,modules/role/manifests/statistics/web.pp,5,0.5,5,0
wikimedia_puppet,modules/role/manifests/toollabs/node/compute/dedicated.pp,4,0.5714285714285714,4,0
wikimedia_puppet,modules/role/manifests/toollabs/node/compute/general.pp,4,0.5714285714285714,4,0
wikimedia_puppet,modules/role/manifests/toollabs/node/web.pp,5,0.42857142857142855,5,0
wikimedia_puppet,modules/role/manifests/toollabs/node/web/generic.pp,2,0.6666666666666666,2,0
wikimedia_puppet,modules/role/manifests/toollabs/node/web/lighttpd.pp,2,0.6,2,0
wikimedia_puppet,modules/role/manifests/logging/kafkatee/webrequest/base.pp,5,0.2,5,0
wikimedia_puppet,modules/role/manifests/logging/kafkatee/webrequest/ops.pp,6,0.375,6,0
wikimedia_puppet,modules/role/manifests/logging/mediawiki/errors.pp,4,0.4,4,0
wikimedia_puppet,modules/role/manifests/logging/mediawiki/udp2log.pp,12,0.25,5,7
wikimedia_puppet,modules/role/manifests/dumps/server.pp,2,0.6666666666666666,2,0
wikimedia_puppet,modules/role/manifests/dumps/zim.pp,3,0.3333333333333333,3,0
wikimedia_puppet,modules/role/manifests/wdq_mm/lb.pp,2,0.5,2,0
wikimedia_puppet,modules/role/manifests/wdq_mm/server.pp,2,0.5,2,0
wikimedia_puppet,modules/role/manifests/wikilabels/server.pp,4,0.25,4,0
wikimedia_puppet,modules/role/manifests/wikilabels/staging.pp,4,0.25,4,0
wikimedia_puppet,modules/role/manifests/toollabs/bastion.pp,4,0.3333333333333333,4,0
wikimedia_puppet,modules/role/manifests/toollabs/checker.pp,4,0.4,4,0
wikimedia_puppet,modules/role/manifests/toollabs/common.pp,2,0.6666666666666666,2,0
wikimedia_puppet,modules/role/manifests/toollabs/compute.pp,3,0.5,3,0
wikimedia_puppet,modules/role/manifests/toollabs/cronrunner.pp,3,0.3333333333333333,3,0
wikimedia_puppet,modules/role/manifests/toollabs/mailrelay.pp,3,0.5,3,0
wikimedia_puppet,modules/role/manifests/toollabs/master.pp,3,0.5,3,0
wikimedia_puppet,modules/role/manifests/toollabs/proxy.pp,6,0.3,6,0
wikimedia_puppet,modules/role/manifests/toollabs/redis.pp,4,0.4,4,0
wikimedia_puppet,modules/role/manifests/toollabs/services.pp,6,0.25,6,0
wikimedia_puppet,modules/role/manifests/toollabs/shadow.pp,3,0.5,3,0
wikimedia_puppet,modules/role/manifests/toollabs/static.pp,4,0.4,4,0
wikimedia_puppet,modules/role/manifests/restbase/alerts.pp,2,0.6666666666666666,2,0
wikimedia_puppet,modules/role/manifests/restbase/server.pp,5,0.4444444444444444,5,0
wikimedia_puppet,manifests/role/recommendation_api.pp,1,1.0,1,0
wikimedia_puppet,modules/recommendation_api/manifests/init.pp,3,0.5,3,0
wikimedia_puppet,modules/icinga/manifests/monitor/wdqs.pp,3,0.5,3,0
wikimedia_puppet,modules/labstore/manifests/monitoring/drbd.pp,2,0.5,2,0
wikimedia_puppet,modules/phabricator/manifests/aphlict.pp,5,0.5,5,0
wikimedia_puppet,modules/conftool/manifests/scripts/service.pp,2,0.75,2,0
wikimedia_puppet,modules/lvm/manifests/init.pp,3,0.3333333333333333,3,0
wikimedia_puppet,modules/lvm/manifests/logical_volume.pp,3,0.3333333333333333,3,0
wikimedia_puppet,modules/lvm/manifests/volume.pp,3,0.3333333333333333,3,0
wikimedia_puppet,modules/lvm/manifests/volume_group.pp,2,0.5,2,0
wikimedia_puppet,modules/role/manifests/lvs/realserver.pp,1,1.0,1,0
wikimedia_puppet,modules/standard/manifests/prometheus.pp,1,1.0,1,0
wikimedia_puppet,modules/proxysql/manifests/init.pp,3,0.5714285714285714,3,0
wikimedia_puppet,modules/labstore/manifests/bdsync.pp,5,0.3333333333333333,5,0
wikimedia_puppet,modules/labstore/manifests/device_backup.pp,5,0.5,5,0
wikimedia_puppet,modules/icinga/manifests/event_handlers/raid.pp,5,0.375,5,0
wikimedia_puppet,modules/docker/manifests/init.pp,4,0.2857142857142857,4,0
wikimedia_puppet,modules/profile/manifests/docker/engine.pp,5,0.5625,5,0
wikimedia_puppet,modules/role/manifests/kubernetes/worker.pp,5,0.45454545454545453,5,0
wikimedia_puppet,modules/docker/manifests/configuration.pp,2,0.5,2,0
wikimedia_puppet,modules/role/manifests/labs/db/proxy.pp,4,0.3333333333333333,4,0
wikimedia_puppet,modules/profile/manifests/docker/storage.pp,3,0.6,3,0
wikimedia_puppet,modules/profile/manifests/docker/storage/thinpool.pp,2,0.6666666666666666,2,0
wikimedia_puppet,modules/role/manifests/access_new_install.pp,3,0.3333333333333333,3,0
wikimedia_puppet,modules/role/manifests/apertium.pp,3,0.5,3,0
wikimedia_puppet,modules/role/manifests/aqs.pp,6,0.375,6,0
wikimedia_puppet,modules/role/manifests/archiva.pp,5,0.4444444444444444,5,0
wikimedia_puppet,modules/role/manifests/cassandra.pp,4,0.4,4,0
wikimedia_puppet,modules/role/manifests/changeprop.pp,4,0.5,4,0
wikimedia_puppet,modules/role/manifests/citoid.pp,3,0.5,3,0
wikimedia_puppet,modules/role/manifests/cxserver.pp,3,0.5,3,0
wikimedia_puppet,modules/role/manifests/debug_proxy.pp,5,0.38461538461538464,5,0
wikimedia_puppet,modules/role/manifests/dnsrecursor.pp,6,0.375,6,0
wikimedia_puppet,modules/role/manifests/etcd.pp,4,0.4,4,0
wikimedia_puppet,modules/role/manifests/eventlogging.pp,3,0.5,3,0
wikimedia_puppet,modules/role/manifests/extdist.pp,3,0.3333333333333333,3,0
wikimedia_puppet,modules/role/manifests/graphoid.pp,3,0.5,3,0
wikimedia_puppet,modules/role/manifests/horizon.pp,4,0.25,4,0
wikimedia_puppet,modules/role/manifests/icinga.pp,14,0.26666666666666666,8,6
wikimedia_puppet,modules/role/manifests/installserver.pp,3,0.5,3,0
wikimedia_puppet,modules/role/manifests/ipsec.pp,6,0.2727272727272727,6,0
wikimedia_puppet,modules/role/manifests/jobqueue_redis.pp,2,0.6666666666666666,2,0
wikimedia_puppet,modules/role/manifests/jsbench.pp,2,0.6666666666666666,2,0
wikimedia_puppet,modules/role/manifests/kibana.pp,2,0.5,2,0
wikimedia_puppet,modules/role/manifests/librenms.pp,8,0.18181818181818182,6,2
wikimedia_puppet,modules/role/manifests/logstash.pp,5,0.3333333333333333,5,0
wikimedia_puppet,modules/role/manifests/mariadb.pp,14,0.475,5,9
wikimedia_puppet,modules/role/manifests/mathoid.pp,3,0.5,3,0
wikimedia_puppet,modules/role/manifests/memcached.pp,6,0.3333333333333333,6,0
wikimedia_puppet,modules/role/manifests/mirrors.pp,4,0.375,4,0
wikimedia_puppet,modules/role/manifests/mobileapps.pp,2,0.6666666666666666,2,0
wikimedia_puppet,modules/role/manifests/mw_rc_irc.pp,5,0.5,5,0
wikimedia_puppet,modules/role/manifests/ntp.pp,4,0.5,4,0
wikimedia_puppet,modules/role/manifests/ocg.pp,5,0.3333333333333333,5,0
wikimedia_puppet,modules/role/manifests/parsoid.pp,5,0.375,5,0
wikimedia_puppet,modules/role/manifests/pmacct.pp,5,0.2857142857142857,5,0
wikimedia_puppet,modules/role/manifests/puppet_compiler.pp,5,0.5,5,0
wikimedia_puppet,modules/role/manifests/pybal_config.pp,1,1.0,1,0
wikimedia_puppet,modules/role/manifests/pybaltest.pp,4,0.375,4,0
wikimedia_puppet,modules/role/manifests/rcstream.pp,4,0.4,4,0
wikimedia_puppet,modules/role/manifests/recommendation_api.pp,1,1.0,1,0
wikimedia_puppet,modules/role/manifests/sca.pp,3,0.5,3,0
wikimedia_puppet,modules/role/manifests/scb.pp,6,0.42857142857142855,6,0
wikimedia_puppet,modules/role/manifests/sentry.pp,3,0.3333333333333333,3,0
wikimedia_puppet,modules/role/manifests/simplelamp.pp,2,0.5,2,0
wikimedia_puppet,modules/role/manifests/simplelap.pp,4,0.4,4,0
wikimedia_puppet,modules/role/manifests/simplestatic.pp,3,0.3333333333333333,3,0
wikimedia_puppet,modules/role/manifests/smokeping.pp,3,0.6363636363636364,3,0
wikimedia_puppet,modules/role/manifests/statsd.pp,4,0.5,4,0
wikimedia_puppet,modules/role/manifests/statsite.pp,4,0.5,4,0
wikimedia_puppet,modules/role/manifests/tcpircbot.pp,6,0.3333333333333333,6,0
wikimedia_puppet,modules/role/manifests/tendril.pp,6,0.375,6,0
wikimedia_puppet,modules/role/manifests/torrus.pp,5,0.3333333333333333,5,0
wikimedia_puppet,modules/role/manifests/url_downloader.pp,5,0.2857142857142857,5,0
wikimedia_puppet,modules/role/manifests/ve.pp,2,0.6666666666666666,2,0
wikimedia_puppet,modules/role/manifests/wdqs.pp,5,0.5,5,0
wikimedia_puppet,modules/role/manifests/webperf.pp,6,0.375,6,0
wikimedia_puppet,modules/role/manifests/wikimania_scholarships.pp,5,0.3333333333333333,5,0
wikimedia_puppet,modules/role/manifests/xenon.pp,2,0.6666666666666666,2,0
wikimedia_puppet,modules/role/manifests/xhgui.pp,1,1.0,1,0
wikimedia_puppet,modules/role/manifests/zotero.pp,3,0.3333333333333333,3,0
wikimedia_puppet,modules/role/manifests/snapshot/testbed.pp,2,0.5,2,0
wikimedia_puppet,modules/docker/manifests/registry/web.pp,2,0.75,2,0
wikimedia_puppet,modules/postgresql/manifests/slave_users.pp,2,0.6666666666666666,2,0
wikimedia_puppet,modules/prometheus/manifests/varnish_config.pp,1,1.0,1,0
wikimedia_puppet,modules/prometheus/manifests/varnish_2layer.pp,2,0.8333333333333334,2,0
wikimedia_puppet,modules/mgmt/manifests/init.pp,2,0.75,2,0
wikimedia_puppet,modules/role/manifests/mgmt/drac_ilo.pp,1,1.0,1,0
wikimedia_puppet,modules/xdummy/manifests/init.pp,2,0.75,2,0
wikimedia_puppet,modules/contint/manifests/packages/doxygen.pp,1,1.0,1,0
wikimedia_puppet,modules/jupyterhub/manifests/init.pp,6,0.3,6,0
wikimedia_puppet,modules/role/manifests/paws_internal/jupyterhub.pp,5,0.3333333333333333,5,0
wikimedia_puppet,modules/profile/manifests/docker/registry.pp,3,0.7857142857142857,3,0
wikimedia_puppet,modules/role/manifests/docker/registry.pp,3,0.6,3,0
wikimedia_puppet,modules/mtail/manifests/init.pp,4,0.5714285714285714,4,0
wikimedia_puppet,modules/mtail/manifests/program.pp,3,0.3333333333333333,3,0
wikimedia_puppet,modules/role/manifests/labs/db/views.pp,5,0.42857142857142855,5,0
wikimedia_puppet,modules/statistics/manifests/mysql_credentials.pp,2,0.5,2,0
wikimedia_puppet,modules/role/manifests/paws_internal/mysql_access.pp,1,1.0,1,0
wikimedia_puppet,modules/role/manifests/systemtap/devserver.pp,3,0.3333333333333333,3,0
wikimedia_puppet,modules/systemtap/manifests/devserver.pp,1,1.0,1,0
wikimedia_puppet,modules/systemtap/manifests/runtime.pp,1,1.0,1,0
wikimedia_puppet,modules/role/manifests/labs/nfs/secondary_backup/base.pp,2,0.5,2,0
wikimedia_puppet,modules/role/manifests/labs/nfs/secondary_backup/misc.pp,4,0.5714285714285714,4,0
wikimedia_puppet,modules/role/manifests/labs/nfs/secondary_backup/tools.pp,4,0.5714285714285714,4,0
wikimedia_puppet,modules/profile/manifests/docker/builder.pp,3,0.6428571428571429,3,0
wikimedia_puppet,modules/profile/manifests/docker/storage/loopback.pp,2,0.75,2,0
wikimedia_puppet,modules/role/manifests/builder.pp,6,0.3,6,0
wikimedia_puppet,modules/statistics/manifests/packages.pp,10,0.4857142857142857,6,4
wikimedia_puppet,modules/role/manifests/labs/instance_info_dumper.pp,3,0.6,3,0
wikimedia_puppet,modules/monitoring/manifests/graphite_freshness.pp,1,1.0,1,0
wikimedia_puppet,modules/role/manifests/maps/tilerator_user.pp,1,1.0,1,0
wikimedia_puppet,modules/eventstreams/manifests/init.pp,3,0.5,3,0
wikimedia_puppet,modules/role/manifests/eventstreams.pp,5,0.375,5,0
wikimedia_puppet,modules/openstack/manifests/keystone/hooks.pp,3,0.5,3,0
wikimedia_puppet,modules/labstore/manifests/monitoring/secondary.pp,3,0.5,3,0
wikimedia_puppet,modules/profile/manifests/calico/builder.pp,1,1.0,1,0
wikimedia_puppet,modules/role/manifests/calico/builder.pp,3,0.5,3,0
wikimedia_puppet,modules/prometheus/manifests/memcached_exporter.pp,2,0.5,2,0
wikimedia_puppet,modules/role/manifests/prometheus/memcached_exporter.pp,1,1.0,1,0
wikimedia_puppet,modules/prometheus/manifests/cluster_config.pp,4,0.25,4,0
wikimedia_puppet,modules/phabricator/manifests/conf_env.pp,1,1.0,1,0
wikimedia_puppet,modules/contint/manifests/packages/postgresql.pp,1,1.0,1,0
wikimedia_puppet,modules/role/manifests/prometheus/global.pp,6,0.5555555555555556,6,0
wikimedia_puppet,modules/pdfrender/manifests/init.pp,4,0.4,4,0
wikimedia_puppet,modules/role/manifests/pdfrender.pp,3,0.5714285714285714,3,0
wikimedia_puppet,modules/openstack/manifests/nova/hooks.pp,2,0.5,2,0
wikimedia_puppet,modules/role/manifests/labs/openstack/nova/api.pp,1,1.0,1,0
wikimedia_puppet,modules/role/manifests/labs/openstack/nova/common.pp,2,0.5555555555555556,2,0
wikimedia_puppet,modules/role/manifests/labs/openstack/nova/compute.pp,4,0.42857142857142855,4,0
wikimedia_puppet,modules/role/manifests/labs/openstack/nova/controller.pp,4,0.4,4,0
wikimedia_puppet,modules/role/manifests/labs/openstack/nova/manager.pp,5,0.4,5,0
wikimedia_puppet,modules/role/manifests/labs/openstack/nova/network.pp,2,0.6666666666666666,2,0
wikimedia_puppet,modules/role/manifests/labs/openstack/nova/network/bonding.pp,1,1.0,1,0
wikimedia_puppet,modules/role/manifests/trendingedits.pp,3,0.3333333333333333,3,0
wikimedia_puppet,modules/trendingedits/manifests/init.pp,1,1.0,1,0
wikimedia_puppet,modules/trendingedits/manifests/packages.pp,1,1.0,1,0
wikimedia_puppet,modules/role/manifests/labs/db/check_private_data.pp,2,0.8,2,0
wikimedia_puppet,modules/role/manifests/labs/db/common.pp,2,0.5,2,0
wikimedia_puppet,modules/prometheus/manifests/node_vhtcpd.pp,2,0.75,2,0
wikimedia_puppet,modules/role/manifests/mariadb/backup.pp,4,0.42857142857142855,4,0
wikimedia_puppet,modules/role/manifests/mariadb/otrsbackups.pp,4,0.5,4,0
wikimedia_puppet,modules/role/manifests/phabricator/rsync.pp,2,0.8,2,0
wikimedia_puppet,modules/role/manifests/logstash/apifeatureusage.pp,4,0.5,4,0
wikimedia_puppet,modules/role/manifests/logstash/collector.pp,10,0.3103448275862069,7,3
wikimedia_puppet,modules/role/manifests/logstash/elasticsearch.pp,5,0.5238095238095238,5,0
wikimedia_puppet,modules/role/manifests/logstash/eventlogging.pp,3,0.3333333333333333,3,0
wikimedia_puppet,modules/role/manifests/logstash/puppetreports.pp,2,0.5,2,0
wikimedia_puppet,modules/role/manifests/xhgui/app.pp,3,0.6,3,0
wikimedia_puppet,modules/ipmi/manifests/mgmt.pp,1,1.0,1,0
wikimedia_puppet,modules/ipmi/manifests/monitor.pp,4,0.4,4,0
wikimedia_puppet,modules/role/manifests/installserver/http.pp,2,0.75,2,0
wikimedia_puppet,modules/role/manifests/installserver/proxy.pp,2,0.875,2,0
wikimedia_puppet,modules/role/manifests/installserver/tftp.pp,3,0.5555555555555556,3,0
wikimedia_puppet,modules/role/manifests/installserver/preseed.pp,3,0.6,3,0
wikimedia_puppet,modules/role/manifests/eventlogging/analytics/files.pp,4,0.375,4,0
wikimedia_puppet,modules/role/manifests/eventlogging/analytics/mysql.pp,4,0.631578947368421,4,0
wikimedia_puppet,modules/role/manifests/eventlogging/analytics/processor.pp,3,0.5714285714285714,3,0
wikimedia_puppet,modules/role/manifests/eventlogging/analytics/server.pp,5,0.2857142857142857,5,0
wikimedia_puppet,modules/role/manifests/eventlogging/analytics/zeromq.pp,4,0.25,4,0
wikimedia_puppet,modules/openstack/manifests/clientlib.pp,5,0.5,5,0
wikimedia_puppet,modules/prometheus/manifests/node_gdnsd.pp,2,0.5,2,0
wikimedia_puppet,modules/mediawiki/manifests/maintenance/generatecaptcha.pp,6,0.5,6,0
wikimedia_puppet,modules/role/manifests/mariadb/client.pp,2,0.6666666666666666,2,0
wikimedia_puppet,modules/prometheus/manifests/apache_exporter.pp,2,0.5,2,0
wikimedia_puppet,modules/role/manifests/prometheus/apache_exporter.pp,1,1.0,1,0
wikimedia_puppet,modules/prometheus/manifests/hhvm_exporter.pp,2,0.5,2,0
wikimedia_puppet,modules/role/manifests/prometheus/hhvm_exporter.pp,1,1.0,1,0
wikimedia_puppet,modules/openstack/manifests/observerenv.pp,1,1.0,1,0
wikimedia_puppet,modules/prometheus/manifests/rule.pp,1,1.0,1,0
wikimedia_puppet,modules/role/manifests/labs/db/maintain_dbusers.pp,6,0.4444444444444444,6,0
wikimedia_puppet,modules/profile/manifests/kubernetes/master.pp,4,0.6785714285714286,3,1
wikimedia_puppet,modules/role/manifests/kubernetes/master.pp,3,0.6,3,0
wikimedia_puppet,modules/profile/manifests/kubernetes/node.pp,6,0.7407407407407407,3,3
wikimedia_puppet,modules/calico/manifests/cni.pp,1,1.0,1,0
wikimedia_puppet,modules/calico/manifests/init.pp,3,0.7,3,0
wikimedia_puppet,modules/profile/manifests/calico/kubernetes.pp,1,1.0,1,0
wikimedia_puppet,modules/standard/manifests/ntp/timesyncd.pp,4,0.45454545454545453,4,0
wikimedia_puppet,modules/mediawiki/manifests/maintenance/pageassessments.pp,1,1.0,1,0
wikimedia_puppet,modules/dataset/manifests/rsync/media.pp,1,1.0,1,0
wikimedia_puppet,modules/profile/manifests/base.pp,15,0.14285714285714285,7,8
wikimedia_puppet,modules/profile/manifests/base/certificates.pp,2,0.75,2,0
wikimedia_puppet,modules/profile/manifests/base/labs.pp,4,0.2857142857142857,4,0
wikimedia_puppet,modules/aptrepo/manifests/rsync.pp,3,0.6666666666666666,3,0
wikimedia_puppet,modules/role/manifests/mariadb/dbstore.pp,7,0.375,7,0
wikimedia_puppet,modules/role/manifests/mariadb/dbstore2.pp,5,0.375,5,0
wikimedia_puppet,modules/role/manifests/labs/openstack/designate/server.pp,3,0.3333333333333333,3,0
wikimedia_puppet,modules/role/manifests/labs/openstack/glance/server.pp,1,1.0,1,0
wikimedia_puppet,modules/role/manifests/labs/openstack/keystone/server.pp,4,0.25,4,0
wikimedia_puppet,modules/profile/manifests/etcd.pp,3,0.5714285714285714,3,0
wikimedia_puppet,modules/profile/manifests/etcd/auth.pp,2,0.6666666666666666,2,0
wikimedia_puppet,modules/profile/manifests/etcd/htpasswd_file.pp,1,1.0,1,0
wikimedia_puppet,modules/profile/manifests/etcd/tlsproxy.pp,1,1.0,1,0
wikimedia_puppet,modules/osm/manifests/prometheus.pp,1,1.0,1,0
wikimedia_puppet,modules/role/manifests/configcluster.pp,4,0.4444444444444444,4,0
wikimedia_puppet,modules/toollabs/manifests/check.pp,1,1.0,1,0
wikimedia_puppet,modules/role/manifests/toollabs/precise_reminder.pp,3,0.5,3,0
wikimedia_puppet,modules/profile/manifests/docker/flannel.pp,3,0.3333333333333333,3,0
wikimedia_puppet,modules/wikistats/manifests/cronjob/import.pp,1,1.0,1,0
wikimedia_puppet,modules/wikistats/manifests/cronjob/update.pp,1,1.0,1,0
wikimedia_puppet,modules/etcdmirror/manifests/instance.pp,1,1.0,1,0
wikimedia_puppet,modules/profile/manifests/etcd/replication.pp,2,0.8181818181818182,2,0
wikimedia_puppet,modules/interface/manifests/aggregate_member.pp,1,1.0,1,0
wikimedia_puppet,modules/interface/manifests/rps/modparams.pp,2,0.6666666666666666,2,0
wikimedia_puppet,modules/certspotter/manifests/init.pp,3,0.4,3,0
wikimedia_puppet,modules/role/manifests/certspotter.pp,1,1.0,1,0
wikimedia_puppet,modules/prometheus/manifests/class_config.pp,2,0.8,2,0
wikimedia_puppet,modules/stdlib/examples/file_line.pp,1,1.0,1,0
wikimedia_puppet,modules/stdlib/examples/has_interface_with.pp,1,1.0,1,0
wikimedia_puppet,modules/stdlib/examples/has_ip_address.pp,1,1.0,1,0
wikimedia_puppet,modules/stdlib/examples/has_ip_network.pp,1,1.0,1,0
wikimedia_puppet,modules/stdlib/examples/init.pp,1,1.0,1,0
wikimedia_puppet,modules/stdlib/spec/fixtures/test/manifests/absolute_path.pp,1,1.0,1,0
wikimedia_puppet,modules/stdlib/spec/fixtures/test/manifests/absolutepath.pp,1,1.0,1,0
wikimedia_puppet,modules/stdlib/spec/fixtures/test/manifests/array.pp,1,1.0,1,0
wikimedia_puppet,modules/stdlib/spec/fixtures/test/manifests/bool.pp,1,1.0,1,0
wikimedia_puppet,modules/stdlib/spec/fixtures/test/manifests/ensure_resources.pp,1,1.0,1,0
wikimedia_puppet,modules/stdlib/spec/fixtures/test/manifests/float.pp,1,1.0,1,0
wikimedia_puppet,modules/stdlib/spec/fixtures/test/manifests/hash.pp,1,1.0,1,0
wikimedia_puppet,modules/stdlib/spec/fixtures/test/manifests/httpsurl.pp,1,1.0,1,0
wikimedia_puppet,modules/stdlib/spec/fixtures/test/manifests/httpurl.pp,1,1.0,1,0
wikimedia_puppet,modules/stdlib/spec/fixtures/test/manifests/integer.pp,1,1.0,1,0
wikimedia_puppet,modules/stdlib/spec/fixtures/test/manifests/ip_address.pp,1,1.0,1,0
wikimedia_puppet,modules/stdlib/spec/fixtures/test/manifests/ipv4.pp,1,1.0,1,0
wikimedia_puppet,modules/stdlib/spec/fixtures/test/manifests/ipv6.pp,1,1.0,1,0
wikimedia_puppet,modules/stdlib/spec/fixtures/test/manifests/numeric.pp,1,1.0,1,0
wikimedia_puppet,modules/stdlib/spec/fixtures/test/manifests/string.pp,1,1.0,1,0
wikimedia_puppet,modules/stdlib/spec/fixtures/test/manifests/unixpath.pp,1,1.0,1,0
wikimedia_puppet,modules/stdlib/spec/fixtures/test/manifests/windowspath.pp,1,1.0,1,0
wikimedia_puppet,modules/stdlib/types/absolutepath.pp,1,1.0,1,0
wikimedia_puppet,modules/stdlib/types/compat/absolute_path.pp,1,1.0,1,0
wikimedia_puppet,modules/stdlib/types/compat/array.pp,1,1.0,1,0
wikimedia_puppet,modules/stdlib/types/compat/bool.pp,1,1.0,1,0
wikimedia_puppet,modules/stdlib/types/compat/float.pp,1,1.0,1,0
wikimedia_puppet,modules/stdlib/types/compat/hash.pp,1,1.0,1,0
wikimedia_puppet,modules/stdlib/types/compat/integer.pp,1,1.0,1,0
wikimedia_puppet,modules/stdlib/types/compat/ip_address.pp,1,1.0,1,0
wikimedia_puppet,modules/stdlib/types/compat/ipv4.pp,1,1.0,1,0
wikimedia_puppet,modules/stdlib/types/compat/ipv6.pp,1,1.0,1,0
wikimedia_puppet,modules/stdlib/types/compat/numeric.pp,1,1.0,1,0
wikimedia_puppet,modules/stdlib/types/compat/re.pp,1,1.0,1,0
wikimedia_puppet,modules/stdlib/types/compat/string.pp,1,1.0,1,0
wikimedia_puppet,modules/stdlib/types/httpsurl.pp,1,1.0,1,0
wikimedia_puppet,modules/stdlib/types/httpurl.pp,1,1.0,1,0
wikimedia_puppet,modules/stdlib/types/unixpath.pp,1,1.0,1,0
wikimedia_puppet,modules/stdlib/types/windowspath.pp,1,1.0,1,0
wikimedia_puppet,modules/profile/manifests/cumin/master.pp,5,0.6,5,0
wikimedia_puppet,modules/profile/manifests/cumin/target.pp,5,0.2857142857142857,5,0
wikimedia_puppet,modules/role/manifests/cluster/management.pp,7,0.23076923076923078,7,0
wikimedia_puppet,modules/role/manifests/cumin/master.pp,2,0.75,2,0
wikimedia_puppet,modules/openstack/manifests/nova/fullstack.pp,6,0.35714285714285715,6,0
wikimedia_puppet,modules/tlsproxy/manifests/nginx_bootstrap.pp,1,1.0,1,0
wikimedia_puppet,modules/role/manifests/labs/openstack/nova/fullstack.pp,1,1.0,1,0
wikimedia_puppet,modules/conftool/manifests/config.pp,2,0.5,2,0
wikimedia_puppet,modules/profile/manifests/conftool/client.pp,2,0.9090909090909091,2,0
wikimedia_puppet,modules/profile/manifests/conftool/master.pp,2,0.5,2,0
wikimedia_puppet,modules/role/manifests/analytics_cluster/apt.pp,1,1.0,1,0
wikimedia_puppet,modules/mediawiki/manifests/maintenance/cache_warmup.pp,1,1.0,1,0
wikimedia_puppet,modules/tlsproxy/manifests/prometheus.pp,2,0.5,2,0
wikimedia_puppet,modules/profile/manifests/discovery/client.pp,1,1.0,1,0
wikimedia_puppet,modules/authdns/manifests/discovery_statefile.pp,1,1.0,1,0
wikimedia_puppet,modules/profile/manifests/configmaster.pp,3,0.5,3,0
wikimedia_puppet,modules/role/manifests/ci/slave/saucelabs.pp,2,0.6666666666666666,2,0
wikimedia_puppet,modules/jupyterhub/manifests/static.pp,2,0.6666666666666666,2,0
wikimedia_puppet,modules/role/manifests/mariadb/sanitarium.pp,2,0.5,2,0
wikimedia_puppet,modules/role/manifests/mariadb/sanitarium2.pp,3,0.6,3,0
wikimedia_puppet,modules/authdns/manifests/ns.pp,2,0.6666666666666666,2,0
wikimedia_puppet,modules/role/manifests/mariadb/parsercache.pp,6,0.5454545454545454,6,0
wikimedia_puppet,modules/role/manifests/mariadb/misc.pp,5,0.6363636363636364,5,0
wikimedia_puppet,modules/role/manifests/mariadb/beta.pp,3,0.3333333333333333,3,0
wikimedia_puppet,modules/role/manifests/mariadb/misc/eventlogging.pp,3,0.6,3,0
wikimedia_puppet,modules/role/manifests/mariadb/misc/phabricator.pp,4,0.7272727272727273,4,0
wikimedia_puppet,modules/role/manifests/mariadb/tendril.pp,5,0.2857142857142857,5,0
wikimedia_puppet,modules/role/manifests/mariadb/core.pp,7,0.5714285714285714,2,5
wikimedia_puppet,modules/role/manifests/mariadb/wikitech.pp,8,0.2727272727272727,8,0
wikimedia_puppet,modules/role/manifests/mariadb/maintenance.pp,1,1.0,1,0
wikimedia_puppet,modules/role/manifests/mariadb/ferm.pp,1,1.0,1,0
wikimedia_puppet,modules/role/manifests/analytics_cluster/refinery/job/camus.pp,2,0.5,2,0
wikimedia_puppet,modules/role/manifests/analytics_cluster/refinery/job/data_check.pp,1,1.0,1,0
wikimedia_puppet,modules/role/manifests/analytics_cluster/refinery/job/data_drop.pp,5,0.4,5,0
wikimedia_puppet,modules/role/manifests/analytics_cluster/refinery/job/guard.pp,2,0.5,2,0
wikimedia_puppet,modules/mediawiki/manifests/maintenance/uploads.pp,2,0.5,2,0
wikimedia_puppet,modules/role/manifests/mariadb/proxy.pp,3,0.4,3,0
wikimedia_puppet,modules/role/manifests/mariadb/proxy/master.pp,2,0.5,2,0
wikimedia_puppet,modules/role/manifests/mariadb/proxy/slaves.pp,1,1.0,1,0
wikimedia_puppet,modules/mariadb/manifests/heartbeat.pp,2,0.6666666666666666,2,0
wikimedia_puppet,modules/mariadb/manifests/mylvmbackup.pp,2,0.5,2,0
wikimedia_puppet,modules/mariadb/manifests/mysqld_safe.pp,1,1.0,1,0
wikimedia_puppet,modules/mariadb/manifests/packages_client.pp,1,1.0,1,0
wikimedia_puppet,modules/mariadb/manifests/service.pp,3,0.6,3,0
wikimedia_puppet,modules/openstack/manifests/keystonechecks.pp,2,0.5,2,0
wikimedia_puppet,modules/profile/manifests/planet/venus.pp,3,0.7,3,0
wikimedia_puppet,modules/role/manifests/planet_server.pp,5,0.45454545454545453,5,0
wikimedia_puppet,modules/profile/manifests/prometheus/snmp_exporter.pp,1,1.0,1,0
wikimedia_puppet,modules/prometheus/manifests/snmp_exporter.pp,2,0.5,2,0
wikimedia_puppet,modules/prometheus/manifests/snmp_exporter/module.pp,1,1.0,1,0
wikimedia_puppet,modules/role/manifests/network/monitor.pp,2,0.6666666666666666,2,0
wikimedia_puppet,modules/profile/manifests/tor/relay.pp,3,0.625,3,0
wikimedia_puppet,modules/role/manifests/tor_relay.pp,2,0.8571428571428571,2,0
wikimedia_puppet,modules/profile/manifests/microsites/annualreport.pp,3,0.7142857142857143,3,0
wikimedia_puppet,modules/profile/manifests/microsites/endowment.pp,2,0.5,2,0
wikimedia_puppet,modules/profile/manifests/microsites/releases.pp,2,0.6666666666666666,2,0
wikimedia_puppet,modules/profile/manifests/microsites/static_bugzilla.pp,3,0.5555555555555556,3,0
wikimedia_puppet,modules/profile/manifests/microsites/transparency.pp,1,1.0,1,0
wikimedia_puppet,modules/role/manifests/webserver_misc_static.pp,4,0.5454545454545454,4,0
wikimedia_puppet,modules/profile/manifests/requesttracker/server.pp,5,0.5454545454545454,5,0
wikimedia_puppet,modules/role/manifests/requesttracker_server.pp,3,0.5,3,0
wikimedia_puppet,modules/role/manifests/parsoid/diffserver.pp,2,0.5,2,0
wikimedia_puppet,modules/profile/manifests/gerrit/server.pp,7,0.5217391304347826,4,3
wikimedia_puppet,modules/role/manifests/analytics_cluster/refinery/job/project_namespace_map.pp,2,0.75,2,0
wikimedia_puppet,modules/role/manifests/analytics_cluster/refinery/job/sqoop_mediawiki.pp,4,0.36363636363636365,4,0
wikimedia_puppet,modules/mediawiki/manifests/maintenance/db_lag_stats.pp,2,0.5,2,0
wikimedia_puppet,modules/role/manifests/netmon/migration.pp,2,0.6666666666666666,2,0
wikimedia_puppet,modules/profile/manifests/jobqueue_redis/instances.pp,2,0.75,2,0
wikimedia_puppet,modules/profile/manifests/jobqueue_redis/master.pp,1,1.0,1,0
wikimedia_puppet,modules/redis/manifests/monitoring/nrpe.pp,1,1.0,1,0
wikimedia_puppet,modules/redis/manifests/monitoring/nrpe_instance.pp,2,0.6666666666666666,2,0
wikimedia_puppet,modules/role/manifests/jobqueue_redis/master.pp,3,0.5714285714285714,3,0
wikimedia_puppet,modules/profile/manifests/failoid.pp,1,1.0,1,0
wikimedia_puppet,modules/role/manifests/failoid.pp,2,0.6666666666666666,2,0
wikimedia_puppet,modules/profile/manifests/multidc_redis/instances.pp,1,1.0,1,0
wikimedia_puppet,modules/profile/manifests/redis/multidc.pp,3,0.7142857142857143,3,0
wikimedia_puppet,modules/profile/manifests/redis/multidc_instance.pp,1,1.0,1,0
wikimedia_puppet,modules/icinga/manifests/monitor/performance.pp,3,0.42857142857142855,3,0
wikimedia_puppet,modules/monitoring/manifests/grafana_alert.pp,3,0.3333333333333333,3,0
wikimedia_puppet,modules/profile/manifests/redis/instance.pp,1,1.0,1,0
wikimedia_puppet,modules/profile/manifests/redis/master.pp,4,0.4,4,0
wikimedia_puppet,modules/profile/manifests/redis/slave.pp,4,0.5714285714285714,4,0
wikimedia_puppet,modules/role/manifests/jobqueue_redis/slave.pp,3,0.5,3,0
wikimedia_puppet,modules/prometheus/manifests/pdu_config.pp,2,0.5,2,0
wikimedia_puppet,modules/statistics/manifests/sites/hue.pp,1,1.0,1,0
wikimedia_puppet,modules/role/manifests/mariadb/labs_deprecated.pp,4,0.3333333333333333,4,0
wikimedia_puppet,modules/service/manifests/node/config.pp,1,1.0,1,0
wikimedia_puppet,modules/service/manifests/node/config/scap3.pp,1,1.0,1,0
wikimedia_puppet,modules/profile/manifests/mediawiki/scap_proxy.pp,1,1.0,1,0
wikimedia_puppet,modules/profile/manifests/mediawiki/common.pp,3,0.6666666666666666,3,0
wikimedia_puppet,modules/postgresql/manifests/db/extension.pp,1,1.0,1,0
wikimedia_puppet,modules/profile/manifests/mediawiki/nutcracker.pp,3,0.3333333333333333,3,0
wikimedia_puppet,modules/profile/manifests/mediawiki/jobrunner.pp,3,0.8823529411764706,3,0
wikimedia_puppet,modules/profile/manifests/memcached/instance.pp,1,1.0,1,0
wikimedia_puppet,modules/profile/manifests/memcached/memkeys.pp,2,0.6666666666666666,2,0
wikimedia_puppet,modules/role/manifests/mediawiki/memcached.pp,3,0.5,3,0
wikimedia_puppet,modules/profile/manifests/url_downloader.pp,4,0.42857142857142855,4,0
wikimedia_puppet,modules/profile/manifests/switchdc.pp,2,0.6666666666666666,2,0
wikimedia_puppet,modules/profile/manifests/elasticsearch.pp,3,0.9166666666666666,1,2
wikimedia_puppet,modules/role/manifests/elasticsearch/beta.pp,3,0.6666666666666666,3,0
wikimedia_puppet,modules/profile/manifests/backup/host.pp,2,0.75,2,0
wikimedia_puppet,modules/profile/manifests/backup/director.pp,6,0.34782608695652173,4,2
wikimedia_puppet,modules/role/manifests/backup.pp,2,0.6666666666666666,2,0
wikimedia_puppet,modules/profile/manifests/backup/storage.pp,2,0.5,2,0
wikimedia_puppet,modules/role/manifests/backup/offsite.pp,1,1.0,1,0
wikimedia_puppet,modules/profile/manifests/etherpad.pp,4,0.5,4,0
wikimedia_puppet,modules/role/manifests/etherpad.pp,2,0.5,2,0
wikimedia_puppet,modules/postgresql/manifests/slave/monitoring.pp,2,0.5,2,0
wikimedia_puppet,modules/profile/manifests/lists.pp,4,0.46153846153846156,4,0
wikimedia_puppet,modules/role/manifests/lists.pp,2,0.8,2,0
wikimedia_puppet,modules/profile/manifests/mw_rc_irc.pp,2,0.5,2,0
wikimedia_puppet,modules/debconf/manifests/seen.pp,2,0.5,2,0
wikimedia_puppet,modules/snapshot/manifests/cron/wikidatadumps/rdf.pp,2,0.8571428571428571,2,0
wikimedia_puppet,modules/role/manifests/deployment/migrate.pp,1,1.0,1,0
wikimedia_puppet,modules/role/manifests/mediawiki/migrate.pp,2,0.5,2,0
wikimedia_puppet,modules/profile/manifests/mediawiki/maintenance.pp,10,0.45454545454545453,6,4
wikimedia_puppet,modules/role/manifests/mediawiki_maintenance.pp,5,0.25,5,0
wikimedia_puppet,modules/profile/manifests/mariadb/maintenance.pp,3,0.6,3,0
wikimedia_puppet,modules/profile/manifests/ores/web.pp,3,0.7272727272727273,3,0
wikimedia_puppet,modules/profile/manifests/ores/worker.pp,1,1.0,1,0
wikimedia_puppet,modules/profile/manifests/ores/redis.pp,3,0.3333333333333333,3,0
wikimedia_puppet,modules/piwik/manifests/init.pp,2,0.5,2,0
wikimedia_puppet,modules/profile/manifests/piwik/instance.pp,2,0.6,2,0
wikimedia_puppet,modules/profile/manifests/piwik/webserver.pp,5,0.5,5,0
wikimedia_puppet,modules/profile/manifests/scap/dsh.pp,1,1.0,1,0
wikimedia_puppet,modules/icinga/manifests/monitor/reading_web.pp,1,1.0,1,0
wikimedia_puppet,modules/profile/manifests/mediawiki/deployment/server.pp,7,0.42857142857142855,4,3
wikimedia_puppet,modules/role/manifests/deployment_server.pp,3,0.5,3,0
wikimedia_puppet,modules/role/manifests/deployment_server/base.pp,1,1.0,1,0
wikimedia_puppet,modules/lvs/manifests/pybal_configuration.pp,2,0.5,2,0
wikimedia_puppet,modules/contint/manifests/packages/hhvm.pp,2,0.5,2,0
wikimedia_puppet,modules/profile/manifests/cassandra.pp,7,0.2727272727272727,7,0
wikimedia_puppet,modules/profile/manifests/restbase.pp,6,0.3333333333333333,6,0
wikimedia_puppet,modules/role/manifests/restbase/base.pp,2,0.5,2,0
wikimedia_puppet,modules/role/manifests/restbase/dev_cluster.pp,1,1.0,1,0
wikimedia_puppet,modules/role/manifests/restbase/test_cluster.pp,1,1.0,1,0
wikimedia_puppet,modules/role/manifests/restbase/production.pp,2,0.5,2,0
wikimedia_puppet,modules/interface/manifests/alias.pp,1,1.0,1,0
wikimedia_puppet,modules/profile/manifests/yubiauth/server.pp,2,0.6666666666666666,2,0
wikimedia_puppet,modules/role/manifests/yubiauth_server.pp,1,1.0,1,0
wikimedia_puppet,modules/profile/manifests/phabricator/main.pp,13,0.41379310344827586,5,8
wikimedia_puppet,modules/profile/manifests/phabricator/rsync.pp,1,1.0,1,0
wikimedia_puppet,modules/role/manifests/phabricator_server.pp,2,0.8333333333333334,2,0
wikimedia_puppet,modules/thumbor/manifests/nutcracker.pp,1,1.0,1,0
wikimedia_puppet,modules/prometheus/manifests/node_puppet_agent.pp,2,0.5,2,0
wikimedia_puppet,modules/elasticsearch/manifests/curator.pp,2,0.75,2,0
wikimedia_puppet,modules/elasticsearch/manifests/curator/config.pp,1,1.0,1,0
wikimedia_puppet,modules/profile/manifests/nutcracker.pp,2,0.6666666666666666,2,0
wikimedia_puppet,modules/profile/manifests/swift/storage/labs.pp,1,1.0,1,0
wikimedia_puppet,modules/mediawiki/manifests/errorpage.pp,3,0.5,3,0
wikimedia_puppet,modules/role/manifests/rancid.pp,2,0.5,2,0
wikimedia_puppet,modules/wikistats/manifests/cronjob/xmldump.pp,2,0.75,2,0
wikimedia_puppet,modules/profile/manifests/zookeeper/server.pp,5,0.5,5,0
wikimedia_puppet,modules/role/manifests/analytics_cluster/druid/zookeeper.pp,2,0.5,2,0
wikimedia_puppet,modules/role/manifests/kubernetes/staging/etcd.pp,1,1.0,1,0
wikimedia_puppet,modules/role/manifests/kubernetes/staging/master.pp,1,1.0,1,0
wikimedia_puppet,modules/graphite/manifests/whisper_cleanup.pp,1,1.0,1,0
wikimedia_puppet,modules/role/manifests/kubernetes/staging/worker.pp,1,1.0,1,0
wikimedia_puppet,modules/profile/manifests/discovery_dashboards/base.pp,2,0.75,2,0
wikimedia_puppet,modules/profile/manifests/discovery_dashboards/development.pp,2,0.6666666666666666,2,0
wikimedia_puppet,modules/profile/manifests/discovery_dashboards/production.pp,2,0.6666666666666666,2,0
wikimedia_puppet,modules/role/manifests/discovery/beta_dashboards.pp,1,1.0,1,0
wikimedia_puppet,modules/role/manifests/discovery/dashboards.pp,2,0.6666666666666666,2,0
wikimedia_puppet,modules/shiny_server/manifests/cran_pkg.pp,1,1.0,1,0
wikimedia_puppet,modules/shiny_server/manifests/git_pkg.pp,1,1.0,1,0
wikimedia_puppet,modules/shiny_server/manifests/github_pkg.pp,1,1.0,1,0
wikimedia_puppet,modules/shiny_server/manifests/init.pp,2,0.8333333333333334,2,0
wikimedia_puppet,modules/profile/manifests/releases/mediawiki.pp,4,0.75,4,0
wikimedia_puppet,modules/role/manifests/releases.pp,3,0.6153846153846154,3,0
wikimedia_puppet,modules/profile/manifests/redis/jobqueue.pp,2,0.6,2,0
wikimedia_puppet,modules/profile/manifests/redis/jobqueue_slave.pp,2,0.6,2,0
wikimedia_puppet,modules/profile/manifests/otrs.pp,4,0.5714285714285714,4,0
wikimedia_puppet,modules/role/manifests/otrs.pp,2,0.5,2,0
wikimedia_puppet,modules/profile/manifests/pybal.pp,8,0.2777777777777778,8,0
wikimedia_puppet,modules/lvs/manifests/kernel_config.pp,4,0.375,4,0
wikimedia_puppet,modules/profile/manifests/lvs.pp,3,0.5,3,0
wikimedia_puppet,modules/profile/manifests/lvs/tagged_interface.pp,1,1.0,1,0
wikimedia_puppet,modules/profile/manifests/cassandra/single_instance.pp,2,0.6666666666666666,2,0
wikimedia_puppet,modules/profile/manifests/maps/apps.pp,2,0.75,2,0
wikimedia_puppet,modules/profile/manifests/maps/cassandra.pp,1,1.0,1,0
wikimedia_puppet,modules/profile/manifests/maps/osm_master.pp,3,0.5555555555555556,3,0
wikimedia_puppet,modules/profile/manifests/maps/osm_slave.pp,3,0.5,3,0
wikimedia_puppet,modules/profile/manifests/maps/postgresql_common.pp,2,0.6666666666666666,2,0
wikimedia_puppet,modules/profile/manifests/maps/tilerator_user.pp,1,1.0,1,0
wikimedia_puppet,modules/role/manifests/maps/test/master.pp,2,0.5,2,0
wikimedia_puppet,modules/role/manifests/maps/test/slave.pp,2,0.5,2,0
wikimedia_puppet,modules/profile/manifests/recommendation_api.pp,3,0.3333333333333333,3,0
wikimedia_puppet,modules/profile/manifests/releases/reprepro.pp,3,0.5,3,0
wikimedia_puppet,modules/profile/manifests/releases/upload.pp,1,1.0,1,0
wikimedia_puppet,modules/role/manifests/cache/canary.pp,3,0.5,3,0
wikimedia_puppet,modules/rsync/manifests/quickdatacopy.pp,2,0.8571428571428571,2,0
wikimedia_puppet,modules/icinga/manifests/monitor/services.pp,2,0.5,2,0
wikimedia_puppet,modules/backup/manifests/hourlyschedule.pp,1,1.0,1,0
wikimedia_puppet,modules/role/manifests/ores/stresstest.pp,2,0.5,2,0
wikimedia_puppet,modules/mariadb/manifests/instance.pp,3,0.5,3,0
wikimedia_puppet,modules/role/manifests/mariadb/dbstore_multiinstance.pp,5,0.5555555555555556,3,2
wikimedia_puppet,modules/diffscan/manifests/init.pp,2,0.6666666666666666,2,0
wikimedia_puppet,modules/profile/manifests/diffscan.pp,1,1.0,1,0
wikimedia_puppet,modules/role/manifests/mariadb/sanitarium3.pp,1,1.0,1,0
wikimedia_puppet,modules/profile/manifests/puppetmaster/backend.pp,6,0.25,6,0
wikimedia_puppet,modules/profile/manifests/puppetmaster/common.pp,6,0.3333333333333333,6,0
wikimedia_puppet,modules/profile/manifests/puppetmaster/frontend.pp,8,0.22727272727272727,5,3
wikimedia_puppet,modules/profile/manifests/puppetmaster/labsenc.pp,1,1.0,1,0
wikimedia_puppet,modules/profile/manifests/piwik/backup.pp,2,0.6666666666666666,2,0
wikimedia_puppet,modules/profile/manifests/puppetmaster/labsencapi.pp,1,1.0,1,0
wikimedia_puppet,modules/role/manifests/labs/puppetmaster/backend.pp,3,0.6153846153846154,3,0
wikimedia_puppet,modules/role/manifests/labs/puppetmaster/frontend.pp,4,0.6,4,0
wikimedia_puppet,modules/profile/manifests/reportupdater/jobs/hadoop.pp,3,0.5,3,0
wikimedia_puppet,modules/profile/manifests/reportupdater/jobs/mysql.pp,4,0.42857142857142855,4,0
wikimedia_puppet,modules/profile/manifests/geowiki.pp,3,0.6,3,0
wikimedia_puppet,modules/profile/manifests/statistics/cruncher.pp,5,0.3333333333333333,5,0
wikimedia_puppet,modules/profile/manifests/statistics/private.pp,5,0.6842105263157895,5,0
wikimedia_puppet,modules/profile/manifests/statistics/web.pp,3,0.5714285714285714,3,0
wikimedia_puppet,modules/role/manifests/statistics/cruncher_new.pp,1,1.0,1,0
wikimedia_puppet,modules/netops/manifests/ripeatlas.pp,4,0.25,4,0
wikimedia_puppet,modules/role/manifests/statistics/private_new.pp,1,1.0,1,0
wikimedia_puppet,modules/profile/manifests/piwik/database.pp,2,0.6,2,0
wikimedia_puppet,modules/kmod/manifests/blacklist.pp,4,0.4,4,0
wikimedia_puppet,modules/kmod/manifests/init.pp,1,1.0,1,0
wikimedia_puppet,modules/kmod/manifests/module.pp,1,1.0,1,0
wikimedia_puppet,modules/kmod/manifests/options.pp,1,1.0,1,0
wikimedia_puppet,modules/profile/manifests/mjolnir/kafka_daemon.pp,3,0.6666666666666666,3,0
wikimedia_puppet,modules/profile/manifests/rabbitmq/server.pp,1,1.0,1,0
wikimedia_puppet,modules/rabbitmq/manifests/init.pp,3,0.4444444444444444,3,0
wikimedia_puppet,modules/rabbitmq/manifests/monitor.pp,3,0.5,3,0
wikimedia_puppet,modules/role/manifests/wmcloud/openstack/control.pp,1,1.0,1,0
wikimedia_puppet,modules/profile/manifests/zookeeper/firewall.pp,1,1.0,1,0
wikimedia_puppet,modules/systemd/manifests/init.pp,1,1.0,1,0
wikimedia_puppet,modules/systemd/manifests/service.pp,2,0.6,2,0
wikimedia_puppet,modules/systemd/manifests/unit.pp,1,1.0,1,0
wikimedia_puppet,modules/profile/manifests/prometheus/apache_exporter.pp,1,1.0,1,0
wikimedia_puppet,modules/profile/manifests/prometheus/hhvm_exporter.pp,1,1.0,1,0
wikimedia_puppet,modules/prometheus/manifests/mysqld_exporter/common.pp,2,0.6666666666666666,2,0
wikimedia_puppet,modules/prometheus/manifests/mysqld_exporter/instance.pp,2,0.75,2,0
wikimedia_puppet,modules/role/manifests/prometheus/mysqld_exporter_instance.pp,1,1.0,1,0
wikimedia_puppet,modules/profile/manifests/prometheus/memcached_exporter.pp,1,1.0,1,0
wikimedia_puppet,modules/role/manifests/ci/slave/webperformance.pp,2,0.5,2,0
wikimedia_puppet,modules/r/manifests/cran.pp,1,1.0,1,0
wikimedia_puppet,modules/r/manifests/git.pp,1,1.0,1,0
wikimedia_puppet,modules/r/manifests/github.pp,1,1.0,1,0
wikimedia_puppet,modules/r/manifests/init.pp,2,0.75,2,0
wikimedia_puppet,modules/openstack2/manifests/cloudrepo.pp,1,1.0,1,0
wikimedia_puppet,modules/profile/manifests/openstack/base/cloudrepo.pp,1,1.0,1,0
wikimedia_puppet,modules/profile/manifests/openstack/labtest/cloudrepo.pp,2,0.6666666666666666,2,0
wikimedia_puppet,modules/profile/manifests/openstack/labtestn/cloudrepo.pp,2,0.75,2,0
wikimedia_puppet,modules/profile/manifests/openstack/main/cloudrepo.pp,1,1.0,1,0
wikimedia_puppet,modules/role/manifests/wmcs/openstack/labtest/control.pp,5,0.42857142857142855,5,0
wikimedia_puppet,modules/role/manifests/wmcs/openstack/labtest/net.pp,3,0.6,3,0
wikimedia_puppet,modules/role/manifests/wmcs/openstack/labtest/services.pp,4,0.625,4,0
wikimedia_puppet,modules/role/manifests/wmcs/openstack/labtest/virt.pp,2,0.8,2,0
wikimedia_puppet,modules/role/manifests/wmcs/openstack/labtest/web.pp,5,0.4,5,0
wikimedia_puppet,modules/role/manifests/wmcs/openstack/labtestn/control.pp,4,0.47368421052631576,4,0
wikimedia_puppet,modules/role/manifests/wmcs/openstack/labtestn/net.pp,2,0.75,2,0
wikimedia_puppet,modules/role/manifests/wmcs/openstack/labtestn/services.pp,4,0.6153846153846154,4,0
wikimedia_puppet,modules/role/manifests/wmcs/openstack/labtestn/virt.pp,2,0.75,2,0
wikimedia_puppet,modules/role/manifests/wmcs/openstack/labtestn/web.pp,2,0.6,2,0
wikimedia_puppet,modules/role/manifests/wmcs/openstack/main/control.pp,5,0.375,5,0
wikimedia_puppet,modules/role/manifests/wmcs/openstack/main/horizon.pp,3,0.5,3,0
wikimedia_puppet,modules/role/manifests/wmcs/openstack/main/net.pp,3,0.5714285714285714,3,0
wikimedia_puppet,modules/role/manifests/wmcs/openstack/main/net_secondary.pp,1,1.0,1,0
wikimedia_puppet,modules/role/manifests/wmcs/openstack/main/services.pp,1,1.0,1,0
wikimedia_puppet,modules/role/manifests/wmcs/openstack/main/virt.pp,2,0.8,2,0
wikimedia_puppet,modules/role/manifests/wmcs/openstack/main/web.pp,2,0.8,2,0
wikimedia_puppet,modules/role/manifests/wmcs/openstack/main/wikitech.pp,4,0.5,4,0
wikimedia_puppet,modules/role/manifests/mariadb/sanitarium_multisource.pp,3,0.5,3,0
wikimedia_puppet,modules/role/manifests/mariadb/sanitarium_multiinstance.pp,4,0.5714285714285714,4,0
wikimedia_puppet,modules/profile/manifests/openstack/base/rabbitmq.pp,5,0.34782608695652173,4,1
wikimedia_puppet,modules/profile/manifests/openstack/labtest/rabbitmq.pp,3,0.375,3,0
wikimedia_puppet,modules/profile/manifests/openstack/labtestn/rabbitmq.pp,3,0.6363636363636364,3,0
wikimedia_puppet,modules/profile/manifests/openstack/main/rabbitmq.pp,3,0.42857142857142855,3,0
wikimedia_puppet,modules/profile/manifests/openstack/base/observerenv.pp,3,0.3333333333333333,3,0
wikimedia_puppet,modules/profile/manifests/openstack/labtest/observerenv.pp,3,0.5,3,0
wikimedia_puppet,modules/profile/manifests/openstack/labtestn/observerenv.pp,3,0.6,3,0
wikimedia_puppet,modules/profile/manifests/openstack/main/observerenv.pp,2,0.5,2,0
wikimedia_puppet,modules/profile/manifests/kafka/broker.pp,6,0.7358490566037735,3,3
wikimedia_puppet,modules/role/manifests/kafka/jumbo/broker.pp,4,0.7222222222222222,4,0
wikimedia_puppet,modules/role/manifests/kafka/simple/broker.pp,1,1.0,1,0
wikimedia_puppet,modules/statistics/manifests/wmde/graphite.pp,3,0.625,3,0
wikimedia_puppet,modules/openstack2/manifests/clientlib.pp,2,0.5,2,0
wikimedia_puppet,modules/profile/manifests/openstack/base/clientlib.pp,3,0.6,3,0
wikimedia_puppet,modules/profile/manifests/openstack/labtest/clientlib.pp,3,0.5,3,0
wikimedia_puppet,modules/profile/manifests/openstack/labtestn/clientlib.pp,3,0.4,3,0
wikimedia_puppet,modules/profile/manifests/openstack/main/clientlib.pp,2,0.5,2,0
wikimedia_puppet,modules/role/manifests/wmcs/openstack/labtest/wikitech.pp,1,1.0,1,0
wikimedia_puppet,modules/puppetdb/manifests/app.pp,3,0.6,3,0
wikimedia_puppet,modules/puppetdb/manifests/config.pp,1,1.0,1,0
wikimedia_puppet,modules/profile/manifests/cdh/apt.pp,1,1.0,1,0
wikimedia_puppet,modules/profile/manifests/hadoop/logstash.pp,2,0.5,2,0
wikimedia_puppet,modules/profile/manifests/java/analytics.pp,1,1.0,1,0
wikimedia_puppet,modules/profile/manifests/ci/docker.pp,3,0.7857142857142857,3,0
wikimedia_puppet,modules/role/manifests/ci/slave/labs/docker.pp,5,0.5,5,0
wikimedia_puppet,modules/r_lang/manifests/cran.pp,1,1.0,1,0
wikimedia_puppet,modules/r_lang/manifests/git.pp,1,1.0,1,0
wikimedia_puppet,modules/r_lang/manifests/github.pp,1,1.0,1,0
wikimedia_puppet,modules/r_lang/manifests/init.pp,2,0.75,2,0
wikimedia_puppet,modules/profile/manifests/pmacct.pp,4,0.25,4,0
wikimedia_puppet,modules/profile/manifests/druid/common.pp,3,0.5,3,0
wikimedia_puppet,modules/profile/manifests/hadoop/client.pp,2,0.5,2,0
wikimedia_puppet,modules/profile/manifests/hive/client.pp,3,0.5714285714285714,3,0
wikimedia_puppet,modules/profile/manifests/oozie/client.pp,2,0.5,2,0
wikimedia_puppet,modules/role/manifests/restbase/production_ng.pp,1,1.0,1,0
wikimedia_puppet,modules/udev/manifests/init.pp,1,1.0,1,0
wikimedia_puppet,modules/udev/manifests/rule.pp,1,1.0,1,0
wikimedia_puppet,modules/snapshot/manifests/cron/dump_global_block.pp,1,1.0,1,0
wikimedia_puppet,modules/prometheus/manifests/jmx_exporter_config.pp,3,0.5,3,0
wikimedia_puppet,modules/prometheus/manifests/jmx_exporter_instance.pp,3,0.6,3,0
wikimedia_puppet,modules/role/manifests/prometheus/services.pp,3,0.8333333333333334,3,0
wikimedia_puppet,modules/snapshot/manifests/cron/dump_global_blocks.pp,2,0.875,2,0
wikimedia_puppet,modules/openstack2/manifests/keystone/cleanup.pp,1,1.0,1,0
wikimedia_puppet,modules/openstack2/manifests/keystone/hooks.pp,1,1.0,1,0
wikimedia_puppet,modules/openstack2/manifests/keystone/monitor.pp,1,1.0,1,0
wikimedia_puppet,modules/openstack2/manifests/keystone/service.pp,1,1.0,1,0
wikimedia_puppet,modules/profile/manifests/openstack/base/keystone/hooks.pp,1,1.0,1,0
wikimedia_puppet,modules/profile/manifests/openstack/base/keystone/service.pp,7,0.28,5,2
wikimedia_puppet,modules/profile/manifests/openstack/labtest/keystone/service.pp,5,0.3333333333333333,5,0
wikimedia_puppet,modules/profile/manifests/openstack/labtestn/keystone/service.pp,5,0.3333333333333333,5,0
wikimedia_puppet,modules/profile/manifests/openstack/main/keystone/service.pp,5,0.3125,5,0
wikimedia_puppet,modules/varnish/manifests/common/browsersec.pp,3,0.5,3,0
wikimedia_puppet,modules/varnish/manifests/common/errorpage.pp,2,0.6666666666666666,2,0
wikimedia_puppet,modules/logrotate/manifests/rule.pp,1,1.0,1,0
wikimedia_puppet,modules/openstack2/manifests/glance/image_sync.pp,1,1.0,1,0
wikimedia_puppet,modules/openstack2/manifests/glance/monitor.pp,1,1.0,1,0
wikimedia_puppet,modules/openstack2/manifests/glance/service.pp,2,0.5,2,0
wikimedia_puppet,modules/profile/manifests/openstack/base/glance.pp,3,0.5555555555555556,3,0
wikimedia_puppet,modules/profile/manifests/openstack/labtest/glance.pp,3,0.5,3,0
wikimedia_puppet,modules/profile/manifests/openstack/labtestn/glance.pp,3,0.6666666666666666,3,0
wikimedia_puppet,modules/profile/manifests/openstack/main/glance.pp,3,0.5,3,0
wikimedia_puppet,modules/ferm/manifests/client.pp,1,1.0,1,0
wikimedia_puppet,modules/openstack2/manifests/monitor/spreadcheck.pp,1,1.0,1,0
wikimedia_puppet,modules/openstack2/manifests/util/admin_scripts.pp,4,0.3333333333333333,4,0
wikimedia_puppet,modules/openstack2/manifests/util/envscripts.pp,1,1.0,1,0
wikimedia_puppet,modules/profile/manifests/dumpsdata.pp,2,0.6666666666666666,2,0
wikimedia_puppet,modules/role/manifests/dumpsdata.pp,1,1.0,1,0
wikimedia_puppet,modules/dumpsnfs/manifests/init.pp,1,1.0,1,0
wikimedia_puppet,modules/profile/manifests/wdqs.pp,4,0.7631578947368421,3,1
wikimedia_puppet,modules/role/manifests/wdqs/labs.pp,2,0.6666666666666666,2,0
wikimedia_puppet,modules/wdqs/manifests/logback_config.pp,1,1.0,1,0
wikimedia_puppet,modules/dumpsdirs/manifests/init.pp,2,0.6666666666666666,2,0
wikimedia_puppet,modules/dumpsuser/manifests/init.pp,1,1.0,1,0
wikimedia_puppet,modules/cassandra/manifests/jbod_device.pp,1,1.0,1,0
wikimedia_puppet,modules/snapshot/manifests/cron/categoriesrdf.pp,2,0.75,2,0
wikimedia_puppet,modules/profile/manifests/mediawiki/jobrunner_tls.pp,1,1.0,1,0
wikimedia_puppet,modules/openstack2/manifests/common.pp,2,0.5,2,0
wikimedia_puppet,modules/openstack2/manifests/nova/api/monitor.pp,1,1.0,1,0
wikimedia_puppet,modules/openstack2/manifests/nova/api/service.pp,1,1.0,1,0
wikimedia_puppet,modules/openstack2/manifests/nova/common.pp,2,0.6666666666666666,2,0
wikimedia_puppet,modules/openstack2/manifests/nova/compute/monitor.pp,1,1.0,1,0
wikimedia_puppet,modules/openstack2/manifests/nova/compute/partition.pp,2,0.5,2,0
wikimedia_puppet,modules/openstack2/manifests/nova/compute/service.pp,1,1.0,1,0
wikimedia_puppet,modules/openstack2/manifests/nova/conductor/monitor.pp,1,1.0,1,0
wikimedia_puppet,modules/openstack2/manifests/nova/conductor/service.pp,1,1.0,1,0
wikimedia_puppet,modules/openstack2/manifests/nova/fullstack/monitor.pp,1,1.0,1,0
wikimedia_puppet,modules/openstack2/manifests/nova/fullstack/service.pp,1,1.0,1,0
wikimedia_puppet,modules/openstack2/manifests/nova/network/monitor.pp,1,1.0,1,0
wikimedia_puppet,modules/openstack2/manifests/nova/network/service.pp,1,1.0,1,0
wikimedia_puppet,modules/openstack2/manifests/nova/scheduler/monitor.pp,1,1.0,1,0
wikimedia_puppet,modules/openstack2/manifests/nova/scheduler/service.pp,1,1.0,1,0
wikimedia_puppet,modules/openstack2/manifests/nova/spiceproxy/service.pp,1,1.0,1,0
wikimedia_puppet,modules/profile/manifests/openstack/base/keystone/db.pp,6,0.3333333333333333,6,0
wikimedia_puppet,modules/profile/manifests/openstack/base/nova/api/service.pp,5,0.2857142857142857,5,0
wikimedia_puppet,modules/profile/manifests/openstack/base/nova/common.pp,2,0.8333333333333334,2,0
wikimedia_puppet,modules/profile/manifests/openstack/base/nova/compute/service.pp,2,0.8,2,0
wikimedia_puppet,modules/profile/manifests/openstack/base/nova/conductor/service.pp,3,0.5,3,0
wikimedia_puppet,modules/profile/manifests/openstack/base/nova/fullstack/service.pp,3,0.5,3,0
wikimedia_puppet,modules/profile/manifests/openstack/base/nova/network/service.pp,3,0.42857142857142855,3,0
wikimedia_puppet,modules/profile/manifests/openstack/base/nova/scheduler/service.pp,2,0.6666666666666666,2,0
wikimedia_puppet,modules/profile/manifests/openstack/base/nova/spiceproxy/service.pp,2,0.6666666666666666,2,0
wikimedia_puppet,modules/profile/manifests/openstack/base/salt.pp,2,0.5,2,0
wikimedia_puppet,modules/profile/manifests/openstack/labtest/nova/api/service.pp,4,0.4,4,0
wikimedia_puppet,modules/profile/manifests/openstack/labtest/nova/common.pp,3,0.5,3,0
wikimedia_puppet,modules/profile/manifests/openstack/labtest/nova/compute/service.pp,2,0.6666666666666666,2,0
wikimedia_puppet,modules/profile/manifests/openstack/labtest/nova/conductor/service.pp,3,0.5,3,0
wikimedia_puppet,modules/profile/manifests/openstack/labtest/nova/network/service.pp,3,0.4,3,0
wikimedia_puppet,modules/profile/manifests/openstack/labtest/nova/scheduler/service.pp,2,0.6666666666666666,2,0
wikimedia_puppet,modules/profile/manifests/openstack/labtest/nova/spiceproxy/service.pp,2,0.5,2,0
wikimedia_puppet,modules/profile/manifests/openstack/labtestn/nova/api/service.pp,3,0.3333333333333333,3,0
wikimedia_puppet,modules/profile/manifests/openstack/labtestn/nova/common.pp,4,0.6,4,0
wikimedia_puppet,modules/profile/manifests/openstack/labtestn/nova/compute/service.pp,1,1.0,1,0
wikimedia_puppet,modules/profile/manifests/openstack/labtestn/nova/conductor/service.pp,2,0.5,2,0
wikimedia_puppet,modules/profile/manifests/openstack/labtestn/nova/scheduler/service.pp,1,1.0,1,0
wikimedia_puppet,modules/profile/manifests/openstack/labtestn/nova/spiceproxy/service.pp,1,1.0,1,0
wikimedia_puppet,modules/profile/manifests/openstack/main/nova/api/service.pp,4,0.4,4,0
wikimedia_puppet,modules/profile/manifests/openstack/main/nova/common.pp,5,0.3333333333333333,5,0
wikimedia_puppet,modules/profile/manifests/openstack/main/nova/compute/service.pp,2,0.75,2,0
wikimedia_puppet,modules/profile/manifests/openstack/main/nova/conductor/service.pp,3,0.5,3,0
wikimedia_puppet,modules/profile/manifests/openstack/main/nova/fullstack/service.pp,3,0.5,3,0
wikimedia_puppet,modules/profile/manifests/openstack/main/nova/network/service.pp,3,0.5,3,0
wikimedia_puppet,modules/profile/manifests/openstack/main/nova/scheduler/service.pp,1,1.0,1,0
wikimedia_puppet,modules/profile/manifests/openstack/main/nova/spiceproxy/service.pp,1,1.0,1,0
wikimedia_puppet,modules/profile/manifests/openstack/main/salt.pp,1,1.0,1,0
wikimedia_puppet,modules/profile/manifests/cpjobqueue.pp,3,0.5,3,0
wikimedia_puppet,modules/profile/manifests/dnsrecursor.pp,5,0.25,5,0
wikimedia_puppet,modules/profile/manifests/mobileapps.pp,2,0.5,2,0
wikimedia_puppet,modules/profile/manifests/mathoid.pp,1,1.0,1,0
wikimedia_puppet,modules/profile/manifests/cxserver.pp,2,0.6666666666666666,2,0
wikimedia_puppet,modules/profile/manifests/apertium.pp,3,0.7142857142857143,3,0
wikimedia_puppet,modules/profile/manifests/trendingedits.pp,1,1.0,1,0
wikimedia_puppet,modules/profile/manifests/eventstreams.pp,3,0.7142857142857143,3,0
wikimedia_puppet,modules/profile/manifests/pdfrender.pp,1,1.0,1,0
wikimedia_puppet,modules/profile/manifests/changeprop.pp,3,0.5,3,0
wikimedia_puppet,modules/profile/manifests/graphoid.pp,1,1.0,1,0
wikimedia_puppet,modules/profile/manifests/changeprop/packages.pp,1,1.0,1,0
wikimedia_puppet,modules/role/manifests/analytics_cluster/coordinator.pp,4,0.5416666666666666,4,0
wikimedia_puppet,modules/profile/manifests/debdeploy.pp,1,1.0,1,0
wikimedia_puppet,modules/profile/manifests/citoid.pp,1,1.0,1,0
wikimedia_puppet,modules/role/manifests/labs/prometheus.pp,7,0.26666666666666666,7,0
wikimedia_puppet,modules/openstack2/manifests/designate/monitor.pp,1,1.0,1,0
wikimedia_puppet,modules/openstack2/manifests/designate/service.pp,2,0.5,2,0
wikimedia_puppet,modules/profile/manifests/openstack/base/designate/service.pp,3,0.38461538461538464,3,0
wikimedia_puppet,modules/profile/manifests/openstack/labtest/designate/service.pp,4,0.36363636363636365,4,0
wikimedia_puppet,modules/profile/manifests/openstack/labtestn/designate/service.pp,4,0.42857142857142855,4,0
wikimedia_puppet,modules/profile/manifests/openstack/main/designate/service.pp,4,0.36363636363636365,4,0
wikimedia_puppet,modules/role/manifests/analytics_cluster/backup.pp,1,1.0,1,0
wikimedia_puppet,modules/role/manifests/analytics_cluster/hadoop/backup/namenode.pp,3,0.3333333333333333,3,0
wikimedia_puppet,modules/3d2png/manifests/deploy.pp,1,1.0,1,0
wikimedia_puppet,modules/dumps/manifests/web/htmldumps.pp,2,0.5,2,0
wikimedia_puppet,modules/dumps/manifests/web/xmldumps.pp,2,0.7857142857142857,2,0
wikimedia_puppet,modules/profile/manifests/dumps/nfs_server.pp,1,1.0,1,0
wikimedia_puppet,modules/profile/manifests/dumps/web/htmldumps.pp,2,0.5,2,0
wikimedia_puppet,modules/profile/manifests/dumps/web/rsync_server.pp,1,1.0,1,0
wikimedia_puppet,modules/profile/manifests/dumps/web/xmldumps.pp,1,1.0,1,0
wikimedia_puppet,modules/role/manifests/dumps/web/htmldumps.pp,1,1.0,1,0
wikimedia_puppet,modules/role/manifests/dumps/web/xmldumps.pp,1,1.0,1,0
wikimedia_puppet,modules/dumps/manifests/generation/client/nfs.pp,1,1.0,1,0
wikimedia_puppet,modules/dumps/manifests/generation/server/dirs.pp,2,0.8181818181818182,2,0
wikimedia_puppet,modules/dumps/manifests/generation/server/nfs.pp,1,1.0,1,0
wikimedia_puppet,modules/profile/manifests/dumps/generation/server.pp,1,1.0,1,0
wikimedia_puppet,modules/role/manifests/dumps/generation/server.pp,1,1.0,1,0
wikimedia_puppet,modules/role/manifests/mariadb/ferm_wmcs.pp,2,0.75,2,0
wikimedia_puppet,modules/profile/manifests/openstack/main/cumin/master.pp,6,0.3333333333333333,6,0
wikimedia_puppet,modules/profile/manifests/openstack/main/cumin/target.pp,4,0.25,4,0
wikimedia_puppet,modules/role/manifests/test.pp,2,0.5,2,0
wikimedia_puppet,modules/dumps/manifests/web/rsync/nginxlogs.pp,1,1.0,1,0
wikimedia_puppet,modules/dumps/manifests/web/xmldumps_active.pp,2,0.6153846153846154,2,0
wikimedia_puppet,modules/profile/manifests/dumps/web/xmldumps_active.pp,3,0.5357142857142857,2,1
wikimedia_puppet,modules/profile/manifests/dumps/web/xmldumps_fallback.pp,2,0.5,2,0
wikimedia_puppet,modules/role/manifests/dumps/web/xmldumps_active.pp,3,0.75,3,0
wikimedia_puppet,modules/role/manifests/dumps/web/xmldumps_fallback.pp,3,0.8,3,0
wikimedia_puppet,modules/dumps/manifests/web/dirs.pp,2,0.8181818181818182,2,0
wikimedia_puppet,modules/dumps/manifests/web/html.pp,3,0.7142857142857143,3,0
wikimedia_puppet,modules/dumps/manifests/rsync/common.pp,1,1.0,1,0
wikimedia_puppet,modules/dumps/manifests/rsync/default.pp,1,1.0,1,0
wikimedia_puppet,modules/dumps/manifests/rsync/media.pp,2,0.8,2,0
wikimedia_puppet,modules/dumps/manifests/rsync/memfix.pp,1,1.0,1,0
wikimedia_puppet,modules/dumps/manifests/rsync/pagecounts_ez.pp,2,0.8,2,0
wikimedia_puppet,modules/dumps/manifests/rsync/peers.pp,2,0.75,2,0
wikimedia_puppet,modules/dumps/manifests/rsync/phab_dump.pp,1,1.0,1,0
wikimedia_puppet,modules/dumps/manifests/rsync/public.pp,1,1.0,1,0
wikimedia_puppet,modules/profile/manifests/dumps/rsyncer.pp,2,0.631578947368421,2,0
wikimedia_puppet,modules/profile/manifests/dumps/rsyncer_peer.pp,2,0.6153846153846154,2,0
wikimedia_puppet,modules/role/manifests/dumps/public/server.pp,2,0.625,2,0
wikimedia_puppet,modules/profile/manifests/dumps/public_server.pp,3,0.5,3,0
wikimedia_puppet,modules/public_dumps/manifests/server.pp,1,1.0,1,0
wikimedia_puppet,modules/profile/manifests/openstack/labtest/salt.pp,1,1.0,1,0
wikimedia_puppet,modules/dumps/manifests/web/fetches/job.pp,2,0.6666666666666666,2,0
wikimedia_puppet,modules/dumps/manifests/web/fetches/kiwix.pp,2,0.8571428571428571,2,0
wikimedia_puppet,modules/dumps/manifests/web/fetches/stats.pp,4,0.5714285714285714,4,0
wikimedia_puppet,modules/dumps/manifests/web/fetches/wikitech_dumps.pp,1,1.0,1,0
wikimedia_puppet,modules/profile/manifests/dumps/fetcher.pp,2,0.875,2,0
wikimedia_puppet,modules/dumps/manifests/copying/labs.pp,3,0.625,3,0
wikimedia_puppet,modules/dumps/manifests/copying/peers.pp,2,0.6666666666666666,2,0
wikimedia_puppet,modules/role/manifests/logstash/apifeatureusage/elasticsearch.pp,1,1.0,1,0
wikimedia_puppet,modules/profile/manifests/druid/worker.pp,1,1.0,1,0
wikimedia_puppet,modules/threedtopng/manifests/deploy.pp,2,0.5,2,0
wikimedia_puppet,modules/dumps/manifests/nfs.pp,1,1.0,1,0
wikimedia_puppet,modules/profile/manifests/dumps/nfs/all.pp,1,1.0,1,0
wikimedia_puppet,modules/profile/manifests/dumps/nfs/generation.pp,1,1.0,1,0
wikimedia_puppet,modules/profile/manifests/dumps/nfs/public.pp,1,1.0,1,0
wikimedia_puppet,modules/dumps/manifests/deprecated/user.pp,1,1.0,1,0
wikimedia_puppet,modules/dumps/manifests/web/nginx_logrot.pp,1,1.0,1,0
wikimedia_puppet,modules/druid/manifests/cdh/hadoop/deep_storage.pp,1,1.0,1,0
wikimedia_puppet,modules/druid/manifests/cdh/hadoop/user.pp,1,1.0,1,0
wikimedia_puppet,modules/profile/manifests/druid/broker.pp,2,0.8333333333333334,2,0
wikimedia_puppet,modules/profile/manifests/druid/coordinator.pp,2,0.6666666666666666,2,0
wikimedia_puppet,modules/profile/manifests/druid/historical.pp,2,0.8,2,0
wikimedia_puppet,modules/profile/manifests/druid/middlemanager.pp,2,0.8,2,0
wikimedia_puppet,modules/profile/manifests/druid/overlord.pp,2,0.8333333333333334,2,0
wikimedia_puppet,modules/role/manifests/druid/analytics/pivot.pp,1,1.0,1,0
wikimedia_puppet,modules/role/manifests/druid/analytics/worker.pp,2,0.8,2,0
wikimedia_puppet,modules/profile/manifests/phabricator/arcanist.pp,1,1.0,1,0
wikimedia_puppet,modules/profile/manifests/zuul/cloner.pp,1,1.0,1,0
wikimedia_puppet,modules/profile/manifests/ci/worker_localhost.pp,2,0.8,2,0
wikimedia_puppet,modules/role/manifests/mariadb/backup_mydumper.pp,1,1.0,1,0
wikimedia_puppet,modules/releases/manifests/proxy_jenkins.pp,2,0.75,2,0
wikimedia_puppet,modules/profile/manifests/kafka/broker/monitoring.pp,4,0.55,4,0
wikimedia_puppet,modules/dumps/manifests/rsync/slowparse_logs.pp,2,0.75,2,0
wikimedia_puppet,modules/profile/manifests/ci/slave.pp,2,0.6666666666666666,2,0
wikimedia_puppet,modules/profile/manifests/ci/website.pp,2,0.75,2,0
wikimedia_puppet,modules/profile/manifests/zuul/merger.pp,1,1.0,1,0
wikimedia_puppet,modules/profile/manifests/zuul/server.pp,3,0.3333333333333333,3,0
wikimedia_puppet,modules/profile/manifests/labs/downloadserver.pp,2,0.5,2,0
wikimedia_puppet,modules/profile/manifests/ci/firewall.pp,3,0.5,3,0
wikimedia_puppet,modules/profile/manifests/ci/jenkins.pp,4,0.4,4,0
wikimedia_puppet,modules/profile/manifests/ci/backup.pp,1,1.0,1,0
wikimedia_puppet,modules/profile/manifests/wikistats.pp,2,0.5,2,0
wikimedia_puppet,modules/jenkins/manifests/common.pp,1,1.0,1,0
wikimedia_puppet,modules/profile/manifests/racktables.pp,2,0.8,2,0
wikimedia_puppet,modules/role/manifests/racktables.pp,2,0.5,2,0
wikimedia_puppet,modules/profile/manifests/microsites/wikibase.pp,3,0.5454545454545454,3,0
wikimedia_puppet,modules/role/manifests/wikibase.pp,1,1.0,1,0
wikimedia_puppet,modules/profile/manifests/cache/kafka/webrequest.pp,7,0.3333333333333333,7,0
wikimedia_puppet,modules/profile/manifests/docker/registry/filebackend.pp,1,1.0,1,0
wikimedia_puppet,modules/profile/manifests/docker/registry/swift.pp,1,1.0,1,0
wikimedia_puppet,modules/profile/manifests/cache/base.pp,5,0.2692307692307692,5,0
wikimedia_puppet,modules/profile/manifests/prometheus/varnish_exporter.pp,1,1.0,1,0
wikimedia_puppet,modules/cacheproxy/manifests/cron_restart.pp,3,0.6,3,0
wikimedia_puppet,modules/cacheproxy/manifests/performance.pp,3,0.7142857142857143,3,0
wikimedia_puppet,modules/cacheproxy/manifests/traffic_pool.pp,1,1.0,1,0
wikimedia_puppet,modules/profile/manifests/cache/ssl/unified.pp,2,0.8333333333333334,2,0
wikimedia_puppet,modules/profile/manifests/cache/text.pp,6,0.47368421052631576,6,0
wikimedia_puppet,modules/profile/manifests/cache/upload.pp,5,0.36363636363636365,5,0
wikimedia_puppet,modules/smart/manifests/init.pp,2,0.7777777777777778,2,0
wikimedia_puppet,modules/profile/manifests/cache/misc.pp,5,0.25,5,0
wikimedia_puppet,modules/cacheproxy/manifests/instance_pair.pp,5,0.3333333333333333,5,0
wikimedia_puppet,modules/role/manifests/maps/test/vectortiles_master.pp,2,0.5,2,0
wikimedia_puppet,modules/pdns_server/manifests/init.pp,1,1.0,1,0
wikimedia_puppet,modules/profile/manifests/openstack/base/pdns/auth/db.pp,3,0.5,3,0
wikimedia_puppet,modules/profile/manifests/openstack/base/pdns/auth/monitor/host_check.pp,1,1.0,1,0
wikimedia_puppet,modules/profile/manifests/openstack/base/pdns/auth/monitor/pdns_control.pp,4,0.4,4,0
wikimedia_puppet,modules/profile/manifests/openstack/base/pdns/auth/service.pp,1,1.0,1,0
wikimedia_puppet,modules/profile/manifests/openstack/labtest/pdns/auth/db.pp,2,0.5,2,0
wikimedia_puppet,modules/profile/manifests/openstack/labtest/pdns/auth/service.pp,1,1.0,1,0
wikimedia_puppet,modules/profile/manifests/openstack/labtestn/pdns/auth/db.pp,2,0.5,2,0
wikimedia_puppet,modules/profile/manifests/openstack/labtestn/pdns/auth/service.pp,2,0.5,2,0
wikimedia_puppet,modules/profile/manifests/openstack/main/pdns/auth/db.pp,2,0.5,2,0
wikimedia_puppet,modules/profile/manifests/openstack/main/pdns/auth/service.pp,1,1.0,1,0
wikimedia_puppet,modules/role/manifests/druid/public/worker.pp,4,0.25,4,0
wikimedia_puppet,modules/profile/manifests/openstack/base/pdns/recursor/monitor/rec_control.pp,3,0.5,3,0
wikimedia_puppet,modules/profile/manifests/openstack/base/pdns/recursor/service.pp,4,0.42857142857142855,4,0
wikimedia_puppet,modules/profile/manifests/openstack/labtest/pdns/recursor/service.pp,3,0.5,3,0
wikimedia_puppet,modules/profile/manifests/openstack/main/pdns/recursor/primary.pp,1,1.0,1,0
wikimedia_puppet,modules/profile/manifests/openstack/main/pdns/recursor/secondary.pp,1,1.0,1,0
wikimedia_puppet,modules/profile/manifests/openstack/main/pdns/recursor/service.pp,3,0.5,3,0
wikimedia_puppet,modules/role/manifests/wmcs/openstack/main/net_standby.pp,3,0.4,3,0
wikimedia_puppet,modules/role/manifests/wmcs/openstack/main/services_primary.pp,6,0.25,6,0
wikimedia_puppet,modules/role/manifests/wmcs/openstack/main/services_secondary.pp,3,0.3333333333333333,3,0
wikimedia_puppet,modules/profile/manifests/aqs.pp,4,0.5,4,0
wikimedia_puppet,modules/role/manifests/analytics_cluster/refinery/job/eventlogging_refine_test.pp,1,1.0,1,0
wikimedia_puppet,modules/openstack2/manifests/horizon/puppetpanel.pp,1,1.0,1,0
wikimedia_puppet,modules/openstack2/manifests/horizon/service.pp,1,1.0,1,0
wikimedia_puppet,modules/profile/manifests/openstack/base/horizon/dashboard.pp,2,0.6,2,0
wikimedia_puppet,modules/profile/manifests/openstack/labtest/horizon/dashboard.pp,2,0.6666666666666666,2,0
wikimedia_puppet,modules/profile/manifests/openstack/main/horizon/dashboard.pp,2,0.5,2,0
wikimedia_puppet,modules/osm/manifests/cleartables_sync.pp,2,0.5714285714285714,2,0
wikimedia_puppet,modules/osm/manifests/meddo.pp,1,1.0,1,0
wikimedia_puppet,modules/docker_pusher/manifests/init.pp,1,1.0,1,0
wikimedia_puppet,modules/profile/manifests/ci/pipeline.pp,2,0.6666666666666666,2,0
wikimedia_puppet,modules/openstack2/manifests/wikitech/openstack_manager.pp,1,1.0,1,0
wikimedia_puppet,modules/openstack2/manifests/wikitech/wikitechprivatesettings.pp,1,1.0,1,0
wikimedia_puppet,modules/profile/manifests/openstack/base/wikitech/monitor.pp,3,0.5,3,0
wikimedia_puppet,modules/profile/manifests/openstack/base/wikitech/service.pp,5,0.3333333333333333,5,0
wikimedia_puppet,modules/profile/manifests/openstack/labtest/wikitech/monitor.pp,2,0.5,2,0
wikimedia_puppet,modules/profile/manifests/openstack/labtest/wikitech/service.pp,1,1.0,1,0
wikimedia_puppet,modules/profile/manifests/openstack/main/wikitech/monitor.pp,1,1.0,1,0
wikimedia_puppet,modules/profile/manifests/openstack/main/wikitech/service.pp,1,1.0,1,0
wikimedia_puppet,modules/profile/manifests/openstack/base/nodepool/monitor.pp,1,1.0,1,0
wikimedia_puppet,modules/profile/manifests/openstack/base/nodepool/service.pp,2,0.5,2,0
wikimedia_puppet,modules/profile/manifests/openstack/main/nodepool/service.pp,2,0.5,2,0
wikimedia_puppet,modules/role/manifests/wmcs/openstack/main/nodepool.pp,2,0.6666666666666666,2,0
wikimedia_puppet,modules/profile/manifests/mariadb/core/multiinstance.pp,5,0.4166666666666667,5,0
wikimedia_puppet,modules/role/manifests/mariadb/core_multiinstance.pp,2,0.5,2,0
wikimedia_puppet,modules/openstack2/manifests/designate/dns_floating_ip_updater.pp,1,1.0,1,0
wikimedia_puppet,modules/profile/manifests/openstack/base/pdns/dns_floating_ip_updater.pp,3,0.5,3,0
wikimedia_puppet,modules/profile/manifests/openstack/labtest/pdns/dns_floating_ip_updater.pp,2,0.6666666666666666,2,0
wikimedia_puppet,modules/profile/manifests/openstack/main/pdns/dns_floating_ip_updater.pp,2,0.5,2,0
wikimedia_puppet,modules/profile/manifests/ci/gitcache.pp,1,1.0,1,0
wikimedia_puppet,modules/confluent/manifests/kafka/common.pp,4,0.3333333333333333,4,0
wikimedia_puppet,modules/profile/manifests/prometheus/jmx_exporter.pp,3,0.5,3,0
wikimedia_puppet,modules/profile/manifests/cyberbot/db.pp,2,0.75,2,0
wikimedia_puppet,modules/profile/manifests/cyberbot/exec.pp,1,1.0,1,0
wikimedia_puppet,modules/role/manifests/cyberbot/db.pp,1,1.0,1,0
wikimedia_puppet,modules/role/manifests/cyberbot/exec.pp,1,1.0,1,0
wikimedia_puppet,modules/profile/manifests/labs/lvm/srv.pp,1,1.0,1,0
wikimedia_puppet,modules/profile/manifests/maps/sources_config.pp,1,1.0,1,0
wikimedia_puppet,modules/systemd/manifests/tmpfile.pp,1,1.0,1,0
wikimedia_puppet,modules/profile/manifests/beta/autoupdater.pp,1,1.0,1,0
wikimedia_puppet,modules/profile/manifests/rlang/dev.pp,1,1.0,1,0
wikimedia_puppet,modules/role/manifests/ci/slave/rlang.pp,1,1.0,1,0
wikimedia_puppet,modules/profile/manifests/package_builder.pp,2,0.5,2,0
wikimedia_puppet,modules/profile/manifests/mariadb/misc/eventlogging/database.pp,5,0.36363636363636365,5,0
wikimedia_puppet,modules/profile/manifests/mariadb/misc/eventlogging/replication.pp,2,0.7,2,0
wikimedia_puppet,modules/role/manifests/mariadb/misc/eventlogging/master.pp,2,0.5,2,0
wikimedia_puppet,modules/role/manifests/mariadb/misc/eventlogging/replica.pp,2,0.5,2,0
wikimedia_puppet,modules/role/manifests/mariadb/misc/eventlogging/replica_config.pp,1,1.0,1,0
wikimedia_puppet,modules/profile/manifests/discovery_computing/base.pp,1,1.0,1,0
wikimedia_puppet,modules/profile/manifests/discovery_computing/bayesian_statistics.pp,1,1.0,1,0
wikimedia_puppet,modules/profile/manifests/discovery_computing/deep_learning.pp,1,1.0,1,0
wikimedia_puppet,modules/profile/manifests/discovery_computing/forecasting.pp,1,1.0,1,0
wikimedia_puppet,modules/profile/manifests/discovery_computing/machine_learning.pp,1,1.0,1,0
wikimedia_puppet,modules/r_lang/manifests/bioc.pp,1,1.0,1,0
wikimedia_puppet,modules/role/manifests/discovery/allstar_cruncher.pp,2,0.5,2,0
wikimedia_puppet,modules/role/manifests/discovery/bayes.pp,2,0.5,2,0
wikimedia_puppet,modules/role/manifests/discovery/deep_learner.pp,2,0.5,2,0
wikimedia_puppet,modules/role/manifests/discovery/forecaster.pp,2,0.5,2,0
wikimedia_puppet,modules/role/manifests/discovery/learner.pp,3,0.3333333333333333,3,0
wikimedia_puppet,modules/interface/manifests/noflow.pp,2,0.8,2,0
wikimedia_puppet,modules/profile/manifests/kafka/mirror.pp,1,1.0,1,0
wikimedia_puppet,modules/role/manifests/kafka/simple/mirror.pp,1,1.0,1,0
wikimedia_puppet,modules/role/manifests/kafka/jumbo/mirror.pp,1,1.0,1,0
wikimedia_puppet,modules/docker/manifests/builder.pp,1,1.0,1,0
wikimedia_puppet,modules/openstack2/manifests/puppet/master/enc.pp,1,1.0,1,0
wikimedia_puppet,modules/openstack2/manifests/puppet/master/encapi.pp,1,1.0,1,0
wikimedia_puppet,modules/openstack2/manifests/puppet/master/instance_info_dumper.pp,1,1.0,1,0
wikimedia_puppet,modules/profile/manifests/openstack/base/puppetmaster/backend.pp,4,0.625,4,0
wikimedia_puppet,modules/profile/manifests/openstack/base/puppetmaster/common.pp,4,0.6666666666666666,4,0
wikimedia_puppet,modules/profile/manifests/openstack/base/puppetmaster/frontend.pp,5,0.5333333333333333,5,0
wikimedia_puppet,modules/profile/manifests/openstack/labtest/puppetmaster/frontend.pp,3,0.7142857142857143,3,0
wikimedia_puppet,modules/profile/manifests/openstack/main/puppetmaster/backend.pp,4,0.5714285714285714,4,0
wikimedia_puppet,modules/profile/manifests/openstack/main/puppetmaster/frontend.pp,3,0.75,3,0
wikimedia_puppet,modules/role/manifests/wmcs/openstack/labtest/puppetmaster/frontend.pp,2,0.5,2,0
wikimedia_puppet,modules/role/manifests/wmcs/openstack/main/puppetmaster/backend.pp,2,0.5,2,0
wikimedia_puppet,modules/role/manifests/wmcs/openstack/main/puppetmaster/frontend.pp,2,0.5,2,0
wikimedia_puppet,modules/role/manifests/prometheus/analytics.pp,7,0.3,7,0
wikimedia_puppet,modules/role/manifests/analytics_cluster/refinery/job/json_refine.pp,1,1.0,1,0
wikimedia_puppet,modules/role/manifests/analytics_cluster/refinery/job/json_refine_job.pp,1,1.0,1,0
wikimedia_puppet,modules/profile/manifests/dumps/generation/worker/common.pp,3,0.5,3,0
wikimedia_puppet,modules/profile/manifests/dumps/generation/worker/cronrunner.pp,2,0.8,2,0
wikimedia_puppet,modules/profile/manifests/dumps/generation/worker/dumper.pp,2,0.6,2,0
wikimedia_puppet,modules/profile/manifests/dumps/generation/worker/monitor.pp,2,0.6666666666666666,2,0
wikimedia_puppet,modules/role/manifests/dumps/generation/worker/dumper.pp,2,0.6666666666666666,2,0
wikimedia_puppet,modules/role/manifests/dumps/generation/worker/dumper_misc.pp,2,0.8,2,0
wikimedia_puppet,modules/role/manifests/dumps/generation/worker/testbed.pp,1,1.0,1,0
wikimedia_puppet,modules/profile/manifests/ci/shipyard.pp,3,0.5,3,0
wikimedia_puppet,modules/role/manifests/prometheus/k8s.pp,4,0.4,4,0
wikimedia_puppet,modules/dumps/manifests/web/cleanups/xml_cleanup.pp,2,0.5,2,0
wikimedia_puppet,modules/dumps/manifests/generation/server/rsyncer.pp,2,0.6,2,0
wikimedia_puppet,modules/profile/manifests/dumps/generation/server/fallback.pp,2,0.5714285714285714,2,0
wikimedia_puppet,modules/profile/manifests/dumps/generation/server/primary.pp,3,0.6,3,0
wikimedia_puppet,modules/profile/manifests/dumps/generation/server/rsync.pp,1,1.0,1,0
wikimedia_puppet,modules/role/manifests/dumps/generation/server/fallback.pp,2,0.875,2,0
wikimedia_puppet,modules/role/manifests/dumps/generation/server/primary.pp,1,1.0,1,0
wikimedia_puppet,modules/snapshot/manifests/cron/wikidatadumps.pp,2,0.75,2,0
wikimedia_puppet,modules/snapshot/manifests/dumps/nfsmount.pp,2,0.6,2,0
wikimedia_puppet,modules/profile/manifests/ci/castor/server.pp,1,1.0,1,0
wikimedia_puppet,modules/profile/manifests/prometheus/redis_exporter.pp,1,1.0,1,0
wikimedia_puppet,modules/prometheus/manifests/redis_exporter.pp,1,1.0,1,0
wikimedia_puppet,modules/profile/manifests/druid/monitoring/broker.pp,1,1.0,1,0
wikimedia_puppet,modules/profile/manifests/druid/monitoring/coordinator.pp,1,1.0,1,0
wikimedia_puppet,modules/profile/manifests/druid/monitoring/historical.pp,1,1.0,1,0
wikimedia_puppet,modules/profile/manifests/druid/monitoring/middlemanager.pp,1,1.0,1,0
wikimedia_puppet,modules/profile/manifests/druid/monitoring/overlord.pp,1,1.0,1,0
wikimedia_puppet,modules/base/manifests/puppet/puppet4.pp,1,1.0,1,0
wikimedia_puppet,modules/mjolnir/manifests/init.pp,3,0.6,3,0
wikimedia_puppet,modules/statistics/manifests/wmde/wdcm.pp,1,1.0,1,0
wikimedia_puppet,modules/profile/manifests/base/firewall.pp,1,1.0,1,0
wikimedia_puppet,modules/profile/manifests/mariadb/ferm.pp,2,0.8,2,0
wikimedia_puppet,modules/profile/manifests/mariadb/monitor.pp,1,1.0,1,0
wikimedia_puppet,modules/profile/manifests/ci/publisher.pp,1,1.0,1,0
wikimedia_puppet,modules/role/manifests/ci/publisher.pp,1,1.0,1,0
wikimedia_puppet,modules/profile/manifests/wmcs/tenants/libraryupgrader.pp,1,1.0,1,0
wikimedia_puppet,modules/prometheus/manifests/redis_exporter_config.pp,2,0.5,2,0
wikimedia_puppet,modules/k8s/manifests/kubeconfig.pp,1,1.0,1,0
wikimedia_puppet,modules/profile/manifests/grafana/production.pp,3,0.6,3,0
wikimedia_puppet,modules/profile/manifests/iegreview.pp,3,0.3333333333333333,3,0
wikimedia_puppet,modules/profile/manifests/wikimania_scholarships.pp,3,0.3333333333333333,3,0
wikimedia_puppet,modules/role/manifests/webserver_misc_apps.pp,3,0.4,3,0
wikimedia_puppet,modules/netbox/manifests/init.pp,4,0.5,4,0
wikimedia_puppet,modules/profile/manifests/netbox.pp,7,0.36,4,3
wikimedia_puppet,modules/role/manifests/netbox.pp,3,0.5,3,0
wikimedia_puppet,modules/profile/manifests/prometheus/druid_exporter.pp,1,1.0,1,0
wikimedia_puppet,modules/prometheus/manifests/druid_exporter.pp,2,0.5,2,0
wikimedia_puppet,modules/openstack/manifests/cloudrepo.pp,5,0.2727272727272727,5,0
wikimedia_puppet,modules/openstack/manifests/designate/dns_floating_ip_updater.pp,2,0.6666666666666666,2,0
wikimedia_puppet,modules/openstack/manifests/designate/monitor.pp,2,0.6666666666666666,2,0
wikimedia_puppet,modules/openstack/manifests/glance/image_sync.pp,1,1.0,1,0
wikimedia_puppet,modules/openstack/manifests/glance/monitor.pp,2,0.6666666666666666,2,0
wikimedia_puppet,modules/openstack/manifests/keystone/cleanup.pp,1,1.0,1,0
wikimedia_puppet,modules/openstack/manifests/keystone/monitor.pp,1,1.0,1,0
wikimedia_puppet,modules/openstack/manifests/monitor/spreadcheck.pp,2,0.5,2,0
wikimedia_puppet,modules/openstack/manifests/nova/api/monitor.pp,2,0.6666666666666666,2,0
wikimedia_puppet,modules/openstack/manifests/nova/api/service.pp,3,0.6,3,0
wikimedia_puppet,modules/openstack/manifests/nova/common.pp,1,1.0,1,0
wikimedia_puppet,modules/openstack/manifests/nova/compute/monitor.pp,3,0.5555555555555556,3,0
wikimedia_puppet,modules/openstack/manifests/nova/compute/partition.pp,1,1.0,1,0
wikimedia_puppet,modules/openstack/manifests/nova/compute/service.pp,3,0.7142857142857143,3,0
wikimedia_puppet,modules/openstack/manifests/nova/conductor/monitor.pp,2,0.6666666666666666,2,0
wikimedia_puppet,modules/openstack/manifests/nova/conductor/service.pp,2,0.75,2,0
wikimedia_puppet,modules/openstack/manifests/nova/fullstack/monitor.pp,2,0.5,2,0
wikimedia_puppet,modules/openstack/manifests/nova/fullstack/service.pp,2,0.6666666666666666,2,0
wikimedia_puppet,modules/openstack/manifests/nova/network/monitor.pp,2,0.6,2,0
wikimedia_puppet,modules/openstack/manifests/nova/network/service.pp,2,0.6666666666666666,2,0
wikimedia_puppet,modules/openstack/manifests/nova/scheduler/monitor.pp,2,0.6666666666666666,2,0
wikimedia_puppet,modules/openstack/manifests/nova/scheduler/service.pp,2,0.8,2,0
wikimedia_puppet,modules/openstack/manifests/nova/spiceproxy/service.pp,1,1.0,1,0
wikimedia_puppet,modules/openstack/manifests/puppet/master/enc.pp,1,1.0,1,0
wikimedia_puppet,modules/openstack/manifests/puppet/master/encapi.pp,3,0.75,3,0
wikimedia_puppet,modules/openstack/manifests/puppet/master/instance_info_dumper.pp,1,1.0,1,0
wikimedia_puppet,modules/openstack/manifests/util/admin_scripts.pp,3,0.5,3,0
wikimedia_puppet,modules/openstack/manifests/util/envscripts.pp,3,0.5,3,0
wikimedia_puppet,modules/openstack/manifests/wikitech/openstack_manager.pp,3,0.5,3,0
wikimedia_puppet,modules/openstack/manifests/wikitech/wikitechprivatesettings.pp,1,1.0,1,0
wikimedia_puppet,modules/profile/manifests/proxysql.pp,2,0.6,2,0
wikimedia_puppet,modules/role/manifests/gerrit.pp,2,0.5,2,0
wikimedia_puppet,modules/profile/manifests/webperf.pp,2,0.8333333333333334,2,0
wikimedia_puppet,modules/bird/manifests/init.pp,2,0.6666666666666666,2,0
wikimedia_puppet,modules/profile/manifests/bird/anycast.pp,2,0.5,2,0
wikimedia_puppet,modules/profile/manifests/statistics/explorer.pp,3,0.3333333333333333,3,0
wikimedia_puppet,modules/role/manifests/statistics/explorer.pp,3,0.5,3,0
wikimedia_puppet,modules/profile/manifests/analytics/refinery.pp,3,0.375,3,0
wikimedia_puppet,modules/profile/manifests/hadoop/backup/namenode.pp,3,0.5,3,0
wikimedia_puppet,modules/profile/manifests/hadoop/firewall/master.pp,2,0.6666666666666666,2,0
wikimedia_puppet,modules/profile/manifests/hadoop/master.pp,4,0.4782608695652174,3,1
wikimedia_puppet,modules/profile/manifests/hadoop/master/standby.pp,4,0.5,4,0
wikimedia_puppet,modules/profile/manifests/hadoop/mysql_password.pp,2,0.5,2,0
wikimedia_puppet,modules/profile/manifests/hadoop/users.pp,1,1.0,1,0
wikimedia_puppet,modules/profile/manifests/hadoop/worker.pp,5,0.4482758620689655,3,2
wikimedia_puppet,modules/dumps/manifests/web/dumpstatusfiles.pp,2,0.5,2,0
wikimedia_puppet,modules/profile/manifests/dumps/web/dumpstatusfiles_sync.pp,1,1.0,1,0
wikimedia_puppet,modules/profile/manifests/analytics/database/meta/backup.pp,3,0.3333333333333333,3,0
wikimedia_puppet,modules/profile/manifests/analytics/database/meta/backup_dest.pp,3,0.5,3,0
wikimedia_puppet,modules/profile/manifests/wmcs/nfs/ferm.pp,1,1.0,1,0
wikimedia_puppet,modules/public_dumps/manifests/nfs.pp,1,1.0,1,0
wikimedia_puppet,modules/profile/manifests/hadoop/common.pp,4,0.3125,4,0
wikimedia_puppet,modules/profile/manifests/bird/anycast_monitoring.pp,1,1.0,1,0
wikimedia_puppet,modules/profile/manifests/prometheus/openldap_exporter.pp,1,1.0,1,0
wikimedia_puppet,modules/mirrors/spec/fixtures/modules/passwords/manifests/mirrors.pp,1,1.0,1,0
wikimedia_puppet,modules/profile/manifests/hadoop/monitoring/datanode.pp,3,0.5,3,0
wikimedia_puppet,modules/profile/manifests/hadoop/monitoring/nodemanager.pp,3,0.5,3,0
wikimedia_puppet,modules/cergen/manifests/init.pp,2,0.75,2,0
wikimedia_puppet,modules/profile/manifests/requesttracker.pp,3,0.3333333333333333,3,0
wikimedia_puppet,modules/role/manifests/requesttracker.pp,1,1.0,1,0
wikimedia_puppet,modules/monitoring/manifests/exported_nagios_host.pp,2,0.6666666666666666,2,0
wikimedia_puppet,modules/monitoring/manifests/exported_nagios_service.pp,2,0.6666666666666666,2,0
wikimedia_puppet,modules/profile/manifests/dumps/generation/worker/dumper_shared.pp,2,0.5,2,0
wikimedia_puppet,modules/dumps/manifests/web/cleanup.pp,2,0.5,2,0
wikimedia_puppet,modules/dumps/manifests/web/cleanups/miscdumps.pp,2,0.6666666666666666,2,0
wikimedia_puppet,modules/profile/manifests/dumps/web/cleanup.pp,2,0.6,2,0
wikimedia_puppet,modules/dumps/manifests/web/cleanups/xmldumps.pp,2,0.5454545454545454,2,0
wikimedia_puppet,modules/dumps/manifests/web/cleanups/miscdatasets.pp,1,1.0,1,0
wikimedia_puppet,modules/profile/manifests/dumps/web/cleanup_miscdatasets.pp,2,0.5,2,0
wikimedia_puppet,modules/role/manifests/dmarc.pp,1,1.0,1,0
wikimedia_puppet,modules/profile/manifests/hadoop/monitoring/history.pp,3,0.3333333333333333,3,0
wikimedia_puppet,modules/profile/manifests/hadoop/monitoring/namenode.pp,3,0.6,3,0
wikimedia_puppet,modules/profile/manifests/hadoop/monitoring/resourcemanager.pp,3,0.6,3,0
wikimedia_puppet,modules/profile/manifests/prometheus/etherpad_exporter.pp,2,0.6666666666666666,2,0
wikimedia_puppet,modules/planet/manifests/rawdogplugin.pp,2,0.5,2,0
wikimedia_puppet,modules/profile/manifests/analytics/database/meta.pp,3,0.4444444444444444,3,0
wikimedia_puppet,modules/profile/manifests/hive/metastore.pp,2,0.8,2,0
wikimedia_puppet,modules/profile/manifests/hive/metastore/database.pp,1,1.0,1,0
wikimedia_puppet,modules/profile/manifests/hive/server.pp,2,0.75,2,0
wikimedia_puppet,modules/profile/manifests/oozie/server.pp,2,0.5,2,0
wikimedia_puppet,modules/profile/manifests/oozie/server/database.pp,1,1.0,1,0
wikimedia_puppet,modules/profile/manifests/ci/package_builder.pp,1,1.0,1,0
wikimedia_puppet,modules/profile/manifests/hive/monitoring/metastore.pp,1,1.0,1,0
wikimedia_puppet,modules/profile/manifests/hive/monitoring/server.pp,1,1.0,1,0
wikimedia_puppet,modules/profile/manifests/oozie/monitoring/server.pp,1,1.0,1,0
wikimedia_puppet,modules/profile/manifests/ci/hhvm.pp,1,1.0,1,0
wikimedia_puppet,modules/profile/manifests/superset.pp,1,1.0,1,0
wikimedia_puppet,modules/superset/manifests/init.pp,2,0.8,2,0
wikimedia_puppet,modules/superset/manifests/proxy.pp,2,0.5,2,0
wikimedia_puppet,modules/dumps/manifests/web/dumplists.pp,2,0.5,2,0
wikimedia_puppet,modules/profile/manifests/ci/browsertests.pp,1,1.0,1,0
wikimedia_puppet,modules/profile/manifests/ci/browsers.pp,1,1.0,1,0
wikimedia_puppet,modules/profile/manifests/mariadb/client.pp,1,1.0,1,0
wikimedia_puppet,modules/profile/manifests/mariadb/wmf_root_client.pp,3,0.7142857142857143,3,0
wikimedia_puppet,modules/profile/manifests/prometheus/ircd_exporter.pp,1,1.0,1,0
wikimedia_puppet,modules/profile/manifests/prometheus/pdns_rec_exporter.pp,2,0.5,2,0
wikimedia_puppet,modules/profile/manifests/elasticsearch/monitoring.pp,1,1.0,1,0
wikimedia_puppet,modules/prometheus/manifests/elasticsearch_exporter.pp,1,1.0,1,0
wikimedia_puppet,modules/role/manifests/wmcs/openstack/labtest/net_standby.pp,1,1.0,1,0
wikimedia_puppet,modules/profile/manifests/mariadb/grants/core.pp,2,0.5,2,0
wikimedia_puppet,modules/profile/manifests/mariadb/grants/production.pp,3,0.5714285714285714,3,0
wikimedia_puppet,modules/profile/manifests/mariadb/monitor/dba.pp,2,0.5,2,0
wikimedia_puppet,modules/profile/manifests/mariadb/monitor/prometheus.pp,2,0.5,2,0
wikimedia_puppet,modules/prometheus/manifests/postgres_exporter.pp,2,0.5,2,0
wikimedia_puppet,modules/profile/manifests/cache/kafka/webrequest/jumbo.pp,3,0.5454545454545454,3,0
wikimedia_puppet,modules/profile/manifests/prometheus/rabbitmq_exporter.pp,4,0.4,4,0
wikimedia_puppet,modules/profile/manifests/prometheus/wdqs_updater_exporter.pp,1,1.0,1,0
wikimedia_puppet,modules/profile/manifests/mariadb/misc/eventlogging/sanitization.pp,3,0.5384615384615384,3,0
wikimedia_puppet,modules/dumps/manifests/server_dirs.pp,1,1.0,1,0
wikimedia_puppet,modules/profile/manifests/prometheus/nutcracker_exporter.pp,2,0.5,2,0
wikimedia_puppet,modules/profile/manifests/mariadb/proxy.pp,2,0.7142857142857143,2,0
wikimedia_puppet,modules/profile/manifests/mariadb/proxy/master.pp,2,0.75,2,0
wikimedia_puppet,modules/profile/manifests/mariadb/proxy/replicas.pp,2,0.6666666666666666,2,0
wikimedia_puppet,modules/role/manifests/mariadb/proxy/replicas.pp,2,0.6666666666666666,2,0
wikimedia_puppet,modules/profile/manifests/prometheus/blazegraph_exporter.pp,1,1.0,1,0
wikimedia_puppet,modules/profile/manifests/prometheus/k8s.pp,2,0.5,2,0
wikimedia_puppet,modules/profile/manifests/mariadb/ferm_wmcs.pp,4,0.5,4,0
wikimedia_puppet,modules/profile/manifests/dumps/web/dumpsuser.pp,2,0.5,2,0
wikimedia_puppet,modules/profile/manifests/prometheus/pdns_exporter.pp,1,1.0,1,0
wikimedia_puppet,modules/profile/manifests/prometheus/k8s/staging.pp,2,0.5,2,0
wikimedia_puppet,modules/profile/manifests/prometheus/postgres_exporter.pp,1,1.0,1,0
wikimedia_puppet,modules/profile/manifests/prometheus/pdns_rec_exporter_wmcs.pp,3,0.3333333333333333,3,0
wikimedia_puppet,modules/profile/manifests/smokeping.pp,2,0.5,2,0
wikimedia_puppet,modules/profile/manifests/dumps/nfs.pp,3,0.3333333333333333,3,0
wikimedia_puppet,modules/profile/manifests/dumps/web/nginx.pp,1,1.0,1,0
wikimedia_puppet,modules/profile/manifests/dumps/web/xmldumps_common.pp,3,0.4,3,0
wikimedia_puppet,modules/profile/manifests/dumps/generation/server/common.pp,1,1.0,1,0
wikimedia_puppet,modules/profile/manifests/dumps/distribution/server.pp,2,0.5,2,0
wikimedia_puppet,modules/role/manifests/dumps/distribution/server.pp,3,0.3333333333333333,3,0
wikimedia_puppet,modules/profile/manifests/dumps/distribution/nfs.pp,1,1.0,1,0
wikimedia_puppet,modules/profile/manifests/zotero.pp,1,1.0,1,0
wikimedia_puppet,modules/rabbitmq/manifests/cleanup.pp,2,0.6666666666666666,2,0
wikimedia_puppet,modules/openstack/manifests/nova/compute/audit.pp,5,0.25,5,0
wikimedia_puppet,modules/profile/manifests/ntp.pp,4,0.5714285714285714,4,0
wikimedia_puppet,modules/profile/manifests/tcpircbot.pp,7,0.3333333333333333,7,0
wikimedia_puppet,modules/profile/manifests/thumbor.pp,3,0.6666666666666666,3,0
wikimedia_puppet,modules/profile/manifests/mediawiki/api.pp,1,1.0,1,0
wikimedia_puppet,modules/profile/manifests/prometheus/alerts.pp,6,0.3333333333333333,5,1
wikimedia_puppet,modules/profile/manifests/prometheus/elasticsearch_exporter.pp,1,1.0,1,0
wikimedia_puppet,modules/profile/manifests/cache/kafka/statsv.pp,4,0.625,4,0
wikimedia_puppet,modules/profile/manifests/rancid.pp,1,1.0,1,0
wikimedia_puppet,modules/profile/manifests/librenms.pp,3,0.5,3,0
wikimedia_puppet,modules/profile/manifests/microsites/peopleweb.pp,2,0.8,2,0
wikimedia_puppet,modules/role/manifests/recursor.pp,1,1.0,1,0
wikimedia_puppet,modules/role/manifests/bastionhost/pop.pp,2,0.5,2,0
wikimedia_puppet,modules/role/manifests/alerting_host.pp,4,0.5,4,0
wikimedia_puppet,modules/profile/manifests/druid/pivot.pp,2,0.5,2,0
wikimedia_puppet,modules/profile/manifests/hue.pp,3,0.5,3,0
wikimedia_puppet,modules/role/manifests/analytics_cluster/webserver.pp,4,0.3333333333333333,4,0
wikimedia_puppet,modules/httpd/manifests/conf.pp,1,1.0,1,0
wikimedia_puppet,modules/httpd/manifests/init.pp,2,0.5,2,0
wikimedia_puppet,modules/httpd/manifests/mod_conf.pp,1,1.0,1,0
wikimedia_puppet,modules/httpd/manifests/mpm.pp,1,1.0,1,0
wikimedia_puppet,modules/httpd/manifests/site.pp,1,1.0,1,0
wikimedia_puppet,modules/wmflib/types/ensure.pp,1,1.0,1,0
wikimedia_puppet,modules/wmflib/types/sourceurl.pp,1,1.0,1,0
wikimedia_puppet,modules/profile/manifests/microsites/httpd.pp,2,0.5,2,0
wikimedia_puppet,modules/role/manifests/servermon.pp,3,0.3333333333333333,3,0
wikimedia_puppet,modules/profile/manifests/microsites/research.pp,1,1.0,1,0
wikimedia_puppet,modules/profile/manifests/labs/lvm/data.pp,1,1.0,1,0
wikimedia_puppet,modules/profile/manifests/dumps/generation/worker/labs_localdisk.pp,1,1.0,1,0
wikimedia_puppet,modules/snapshot/manifests/dumps/datamount.pp,2,0.5,2,0
wikimedia_puppet,modules/role/manifests/dumps/generation/worker/beta_testbed.pp,1,1.0,1,0
wikimedia_puppet,modules/mediawiki/manifests/maintenance/readinglists.pp,2,0.5,2,0
wikimedia_puppet,modules/profile/manifests/statsd.pp,2,0.5,2,0
wikimedia_puppet,modules/role/manifests/graphite/primary.pp,4,0.4,4,0
wikimedia_puppet,modules/role/manifests/kafka/analytics.pp,3,0.6,3,0
wikimedia_puppet,modules/role/manifests/kafka/main.pp,2,0.875,2,0
wikimedia_puppet,modules/role/manifests/labs/monitoring.pp,4,0.25,4,0
wikimedia_puppet,modules/role/manifests/paws_internal.pp,2,0.5,2,0
wikimedia_puppet,modules/profile/manifests/access_new_install.pp,1,1.0,1,0
wikimedia_puppet,modules/profile/manifests/ipmi/mgmt.pp,1,1.0,1,0
wikimedia_puppet,modules/role/manifests/prometheus.pp,3,0.3333333333333333,3,0
wikimedia_puppet,modules/profile/manifests/analytics/refinery/job/camus.pp,3,0.6818181818181818,3,0
wikimedia_puppet,modules/profile/manifests/analytics/refinery/job/data_check.pp,3,0.6,3,0
wikimedia_puppet,modules/profile/manifests/analytics/refinery/job/data_drop.pp,1,1.0,1,0
wikimedia_puppet,modules/profile/manifests/analytics/refinery/job/guard.pp,1,1.0,1,0
wikimedia_puppet,modules/profile/manifests/analytics/refinery/job/json_refine.pp,3,0.5,3,0
wikimedia_puppet,modules/profile/manifests/analytics/refinery/job/json_refine_job.pp,1,1.0,1,0
wikimedia_puppet,modules/profile/manifests/analytics/refinery/job/project_namespace_map.pp,2,0.5,2,0
wikimedia_puppet,modules/profile/manifests/analytics/refinery/job/sqoop_mediawiki.pp,5,0.3,5,0
wikimedia_puppet,modules/profile/manifests/analytics/refinery/source.pp,1,1.0,1,0
wikimedia_puppet,modules/role/manifests/netmon.pp,2,0.6666666666666666,2,0
wikimedia_puppet,modules/profile/manifests/cdh/apt_pin.pp,1,1.0,1,0
wikimedia_puppet,modules/profile/manifests/cache/kafka/certificate.pp,3,0.6,3,0
wikimedia_puppet,modules/toollabs/manifests/ferm_restart_handler.pp,1,1.0,1,0
wikimedia_puppet,modules/toollabs/manifests/ferm_handlers.pp,1,1.0,1,0
wikimedia_puppet,modules/role/manifests/planet.pp,2,0.6666666666666666,2,0
wikimedia_puppet,modules/role/manifests/phabricator.pp,2,0.75,2,0
wikimedia_puppet,modules/profile/manifests/wikilabels.pp,1,1.0,1,0
wikimedia_puppet,modules/profile/manifests/puppetdb.pp,3,0.4,3,0
wikimedia_puppet,modules/profile/manifests/puppetdb/database.pp,3,0.5,3,0
wikimedia_puppet,modules/profile/manifests/analytics/refinery/job/streams_check.pp,3,0.5714285714285714,3,0
wikimedia_puppet,modules/profile/manifests/ci/proxy_common.pp,1,1.0,1,0
wikimedia_puppet,modules/profile/manifests/ci/proxy_jenkins.pp,1,1.0,1,0
wikimedia_puppet,modules/profile/manifests/ci/proxy_zuul.pp,1,1.0,1,0
wikimedia_puppet,modules/role/manifests/netinsights.pp,2,0.5,2,0
wikimedia_puppet,modules/profile/manifests/parsoid/testing.pp,2,0.6666666666666666,2,0
wikimedia_puppet,modules/role/manifests/mariadb/temporary_storage.pp,2,0.5,2,0
wikimedia_puppet,modules/profile/manifests/ganeti.pp,2,0.875,2,0
wikimedia_puppet,modules/profile/manifests/grafana.pp,3,0.6666666666666666,3,0
wikimedia_puppet,modules/profile/manifests/releases/mediawiki/security.pp,1,1.0,1,0
wikimedia_puppet,modules/docker_pkg/manifests/init.pp,2,0.5,2,0
wikimedia_puppet,modules/profile/manifests/shiny_server.pp,1,1.0,1,0
wikimedia_puppet,modules/openstack/manifests/horizon/source_deploy.pp,2,0.5625,2,0
wikimedia_puppet,modules/profile/manifests/openstack/base/horizon/dashboard_source_deploy.pp,2,0.5454545454545454,2,0
wikimedia_puppet,modules/role/manifests/wmcs/openstack/main/labweb.pp,3,0.6666666666666666,3,0
wikimedia_puppet,modules/role/manifests/piwik.pp,2,0.6666666666666666,2,0
wikimedia_puppet,modules/role/manifests/wmcs/web_interfaces.pp,1,1.0,1,0
wikimedia_puppet,modules/rabbitmq/manifests/user.pp,2,0.6666666666666666,2,0
wikimedia_puppet,modules/openstack/manifests/nova/log_fixes.pp,1,1.0,1,0
wikimedia_puppet,modules/ldap/manifests/config/labs.pp,1,1.0,1,0
wikimedia_puppet,modules/profile/manifests/ldap/client/labs.pp,1,1.0,1,0
wikimedia_puppet,modules/profile/manifests/openldap/management.pp,1,1.0,1,0
wikimedia_puppet,modules/openstack/manifests/nova/common/base.pp,3,0.3333333333333333,3,0
wikimedia_puppet,modules/openstack/manifests/nova/common/neutron.pp,5,0.3333333333333333,5,0
wikimedia_puppet,modules/openstack/manifests/nova/common/nova_network.pp,3,0.4,3,0
wikimedia_puppet,modules/profile/manifests/openstack/base/nova/common/neutron.pp,4,0.3333333333333333,4,0
wikimedia_puppet,modules/profile/manifests/openstack/base/nova/common/nova_network.pp,3,0.4,3,0
wikimedia_puppet,modules/profile/manifests/openstack/main/horizon/dashboard_source_deploy.pp,2,0.5714285714285714,2,0
wikimedia_puppet,modules/role/manifests/ores.pp,1,1.0,1,0
wikimedia_puppet,modules/profile/manifests/beta/icu57.pp,1,1.0,1,0
wikimedia_puppet,modules/openstack/manifests/keystone/bootstrap.pp,2,0.5,2,0
wikimedia_puppet,modules/profile/manifests/openstack/base/keystone/bootstrap.pp,1,1.0,1,0
wikimedia_puppet,modules/profile/manifests/openstack/labtestn/keystone/bootstrap.pp,1,1.0,1,0
wikimedia_puppet,modules/profile/manifests/mariadb/backup/bacula.pp,1,1.0,1,0
wikimedia_puppet,modules/profile/manifests/mariadb/backup/mydumper.pp,2,0.625,2,0
wikimedia_puppet,modules/profile/manifests/mariadb/dbstore_multiinstance.pp,2,0.8,2,0
wikimedia_puppet,modules/profile/manifests/prometheus/mysqld_exporter_instance.pp,1,1.0,1,0
wikimedia_puppet,modules/role/manifests/mariadb/dbstore_multiinstance_backups.pp,1,1.0,1,0
wikimedia_puppet,modules/profile/manifests/kafka/burrow.pp,4,0.5,4,0
wikimedia_puppet,modules/profile/manifests/kafka/burrow/analytics.pp,2,0.5,2,0
wikimedia_puppet,modules/profile/manifests/kafka/burrow/main/codfw.pp,1,1.0,1,0
wikimedia_puppet,modules/profile/manifests/kafka/burrow/main/eqiad.pp,1,1.0,1,0
wikimedia_puppet,modules/base/manifests/auto_restarts.pp,1,1.0,1,0
wikimedia_puppet,modules/base/manifests/service_auto_restart.pp,1,1.0,1,0
wikimedia_puppet,modules/profile/manifests/prometheus/burrow_exporter.pp,2,0.6666666666666666,2,0
wikimedia_puppet,modules/prometheus/manifests/burrow_exporter.pp,2,0.6666666666666666,2,0
wikimedia_puppet,modules/profile/manifests/openstack/base/striker/web.pp,1,1.0,1,0
wikimedia_puppet,modules/openstack/manifests/neutron/l3_agent.pp,4,0.5384615384615384,4,0
wikimedia_puppet,modules/openstack/manifests/neutron/service.pp,3,0.7777777777777778,3,0
wikimedia_puppet,modules/profile/manifests/openstack/base/neutron/l3_agent.pp,3,0.6,3,0
wikimedia_puppet,modules/profile/manifests/openstack/base/neutron/service.pp,2,0.5,2,0
wikimedia_puppet,modules/profile/manifests/openstack/labtestn/neutron/l3_agent.pp,3,0.5833333333333334,3,0
wikimedia_puppet,modules/profile/manifests/openstack/labtestn/neutron/service.pp,1,1.0,1,0
wikimedia_puppet,modules/role/manifests/mariadb/core_test.pp,3,0.6,3,0
wikimedia_puppet,modules/toollabs/manifests/apt_pinning.pp,3,0.8333333333333334,3,0
wikimedia_puppet,modules/kafkatee/manifests/init.pp,2,0.5,2,0
wikimedia_puppet,modules/kafkatee/manifests/input.pp,1,1.0,1,0
wikimedia_puppet,modules/kafkatee/manifests/output.pp,2,0.5,2,0
wikimedia_puppet,modules/profile/manifests/kafkatee/webrequest/base.pp,3,0.6,3,0
wikimedia_puppet,modules/profile/manifests/kafkatee/webrequest/ops.pp,1,1.0,1,0
wikimedia_puppet,modules/role/manifests/logging/webrequest/ops.pp,1,1.0,1,0
wikimedia_puppet,modules/profile/manifests/mariadb/misc/tendril.pp,3,0.5,3,0
wikimedia_puppet,modules/role/manifests/mariadb/misc/tendril.pp,3,0.5,3,0
wikimedia_puppet,modules/profile/manifests/prometheus/wmf_elasticsearch_exporter.pp,2,0.6666666666666666,2,0
wikimedia_puppet,modules/prometheus/manifests/wmf_elasticsearch_exporter.pp,2,0.75,2,0
wikimedia_puppet,modules/profile/manifests/openstack/base/nutcracker.pp,3,0.4444444444444444,3,0
wikimedia_puppet,modules/profile/manifests/openstack/labtest/nutcracker.pp,1,1.0,1,0
wikimedia_puppet,modules/profile/manifests/openstack/labtestn/nutcracker.pp,1,1.0,1,0
wikimedia_puppet,modules/profile/manifests/openstack/main/nutcracker.pp,1,1.0,1,0
wikimedia_puppet,modules/profile/manifests/microsites/design.pp,2,0.6666666666666666,2,0
wikimedia_puppet,modules/profile/manifests/kafka/monitoring.pp,1,1.0,1,0
wikimedia_puppet,modules/role/manifests/kafka/monitoring.pp,1,1.0,1,0
wikimedia_puppet,modules/profile/manifests/maps/alerts.pp,1,1.0,1,0
wikimedia_puppet,modules/openstack/manifests/backports.pp,2,0.6666666666666666,2,0
wikimedia_puppet,modules/profile/manifests/openstack/base/backports.pp,1,1.0,1,0
wikimedia_puppet,modules/puppetmaster/types/backends.pp,1,1.0,1,0
wikimedia_puppet,modules/openstack/manifests/keystone/monitor/projects_and_users.pp,1,1.0,1,0
wikimedia_puppet,modules/openstack/manifests/keystone/monitor/services.pp,1,1.0,1,0
wikimedia_puppet,modules/rabbitmq/manifests/plugins.pp,1,1.0,1,0
wikimedia_puppet,modules/role/manifests/mariadb/backups.pp,1,1.0,1,0
wikimedia_puppet,modules/toollabs/manifests/base.pp,1,1.0,1,0
wikimedia_puppet,modules/profile/manifests/hadoop/spark2.pp,1,1.0,1,0
wikimedia_puppet,modules/openstack/manifests/wikitech/web.pp,2,0.8,2,0
wikimedia_puppet,modules/profile/manifests/openstack/base/wikitech/web.pp,4,0.6363636363636364,4,0
wikimedia_puppet,modules/profile/manifests/openstack/main/wikitech/web.pp,3,0.3333333333333333,3,0
wikimedia_puppet,modules/role/manifests/toollabs/base.pp,1,1.0,1,0
wikimedia_puppet,modules/profile/manifests/locales/all.pp,1,1.0,1,0
wikimedia_puppet,modules/profile/manifests/locales/extended.pp,1,1.0,1,0
wikimedia_puppet,modules/openstack/manifests/wikitech/wikitech_static_sync.pp,1,1.0,1,0
wikimedia_puppet,modules/profile/manifests/dumps/distribution/datasets/cleanup.pp,2,0.5,2,0
wikimedia_puppet,modules/profile/manifests/dumps/distribution/datasets/cleanup_miscdatasets.pp,2,0.5,2,0
wikimedia_puppet,modules/profile/manifests/dumps/distribution/datasets/dumpstatusfiles_sync.pp,2,0.5,2,0
wikimedia_puppet,modules/profile/manifests/dumps/distribution/datasets/rsync_server.pp,1,1.0,1,0
wikimedia_puppet,modules/profile/manifests/dumps/generation/server/cleanup.pp,2,0.5,2,0
wikimedia_puppet,modules/profile/manifests/dumps/generation/server/dumpstatusfiles_sync.pp,1,1.0,1,0
wikimedia_puppet,modules/profile/manifests/dumps/distribution/datasets/rsync_config.pp,2,0.5,2,0
wikimedia_puppet,modules/profile/manifests/dumps/distribution/mirrors/rsync_config.pp,2,0.75,2,0
wikimedia_puppet,modules/profile/manifests/dumps/distribution/rsync.pp,2,0.5,2,0
wikimedia_puppet,modules/wmflib/types/ipport.pp,1,1.0,1,0
wikimedia_puppet,modules/profile/manifests/dumps/distribution/ferm.pp,2,0.6666666666666666,2,0
wikimedia_puppet,modules/profile/manifests/jupyterhub.pp,1,1.0,1,0
wikimedia_puppet,modules/role/manifests/swap.pp,4,0.5,4,0
wikimedia_puppet,modules/icinga/manifests/monitor/etcd_mw_config.pp,4,0.4,4,0
wikimedia_puppet,modules/role/manifests/wdqs_internal.pp,1,1.0,1,0
wikimedia_puppet,modules/openstack/manifests/nova/bootstrap.pp,1,1.0,1,0
wikimedia_puppet,modules/profile/manifests/cache/kafka/eventlogging.pp,5,0.3333333333333333,5,0
wikimedia_puppet,modules/profile/manifests/dumps/distribution/datasets/fetcher.pp,4,0.5,4,0
wikimedia_puppet,modules/systemd/types/unit_type.pp,1,1.0,1,0
wikimedia_puppet,modules/role/manifests/eventlogging/analytics/legacy.pp,1,1.0,1,0
wikimedia_puppet,modules/profile/manifests/analytics/refinery/job/refine.pp,3,0.8333333333333334,3,0
wikimedia_puppet,modules/profile/manifests/analytics/refinery/job/refine_job.pp,1,1.0,1,0
wikimedia_puppet,modules/profile/manifests/kubernetes/deployment_server.pp,1,1.0,1,0
wikimedia_puppet,modules/openstack/manifests/nova/rabbit.pp,1,1.0,1,0
wikimedia_puppet,modules/openstack/manifests/neutron/base.pp,1,1.0,1,0
wikimedia_puppet,modules/openstack/manifests/neutron/rabbit.pp,1,1.0,1,0
wikimedia_puppet,modules/openstack/manifests/neutron/common.pp,5,0.2857142857142857,5,0
wikimedia_puppet,modules/openstack/manifests/neutron/dhcp_agent.pp,4,0.375,4,0
wikimedia_puppet,modules/openstack/manifests/neutron/metadata_agent.pp,4,0.42857142857142855,4,0
wikimedia_puppet,modules/openstack/manifests/neutron/ml2.pp,2,0.6666666666666666,2,0
wikimedia_puppet,modules/profile/manifests/openstack/base/neutron/common.pp,4,0.25,4,0
wikimedia_puppet,modules/profile/manifests/openstack/base/neutron/dhcp_agent.pp,3,0.3333333333333333,3,0
wikimedia_puppet,modules/profile/manifests/openstack/base/neutron/metadata_agent.pp,2,0.6666666666666666,2,0
wikimedia_puppet,modules/profile/manifests/openstack/base/neutron/ml2.pp,2,0.6666666666666666,2,0
wikimedia_puppet,modules/profile/manifests/openstack/labtestn/neutron/common.pp,4,0.25,4,0
wikimedia_puppet,modules/profile/manifests/openstack/labtestn/neutron/dhcp_agent.pp,3,0.3333333333333333,3,0
wikimedia_puppet,modules/profile/manifests/openstack/labtestn/neutron/metadata_agent.pp,2,0.6666666666666666,2,0
wikimedia_puppet,modules/profile/manifests/openstack/labtestn/neutron/ml2.pp,2,0.6666666666666666,2,0
wikimedia_puppet,modules/profile/manifests/mariadb/ferm_misc.pp,2,0.6666666666666666,2,0
wikimedia_puppet,modules/profile/manifests/openstack/labtest/horizon/dashboard_source_deploy.pp,2,0.8,2,0
wikimedia_puppet,modules/profile/manifests/openstack/labtest/wikitech/web.pp,2,0.6666666666666666,2,0
wikimedia_puppet,modules/role/manifests/wmcs/openstack/labtest/labweb.pp,1,1.0,1,0
wikimedia_puppet,modules/profile/manifests/dumps/distribution/web.pp,2,0.5,2,0
wikimedia_puppet,modules/jupyterhub_old/manifests/init.pp,1,1.0,1,0
wikimedia_puppet,modules/jupyterhub_old/manifests/static.pp,1,1.0,1,0
wikimedia_puppet,modules/profile/manifests/swap.pp,2,0.8,2,0
wikimedia_puppet,modules/openstack/manifests/neutron/bootstrap.pp,1,1.0,1,0
wikimedia_puppet,modules/openstack/manifests/nova/compute/kmod.pp,2,0.5,2,0
wikimedia_puppet,modules/role/manifests/mariadb/labtestwikitech.pp,3,0.5,3,0
wikimedia_puppet,modules/profile/manifests/analytics/cluster/client.pp,2,0.6,2,0
wikimedia_puppet,modules/profile/manifests/puppet_compiler.pp,1,1.0,1,0
wikimedia_puppet,modules/profile/manifests/puppet_compiler/postgres_database.pp,1,1.0,1,0
wikimedia_puppet,modules/puppet_compiler/manifests/legacy_local_database.pp,1,1.0,1,0
wikimedia_puppet,modules/openstack/manifests/neutron/linuxbridge_agent.pp,4,0.5,4,0
wikimedia_puppet,modules/profile/manifests/openstack/base/neutron/linuxbridge_agent.pp,2,0.75,2,0
wikimedia_puppet,modules/profile/manifests/analytics/cluster/elasticsearch.pp,2,0.5,2,0
wikimedia_puppet,modules/profile/manifests/analytics/cluster/rsyncd.pp,1,1.0,1,0
wikimedia_puppet,modules/profile/manifests/analytics/cluster/users.pp,1,1.0,1,0
wikimedia_puppet,modules/profile/manifests/mediawiki/hhvm.pp,2,0.6,2,0
wikimedia_puppet,modules/profile/manifests/puppetboard.pp,3,0.45454545454545453,3,0
wikimedia_puppet,modules/role/manifests/puppetboard.pp,1,1.0,1,0
wikimedia_puppet,modules/profile/manifests/hadoop/balancer.pp,2,0.6666666666666666,2,0
wikimedia_puppet,modules/profile/manifests/hive/site_hdfs.pp,2,0.5,2,0
wikimedia_puppet,modules/profile/manifests/performance/coal.pp,2,0.5,2,0
wikimedia_puppet,modules/profile/manifests/performance/site.pp,6,0.25,6,0
wikimedia_puppet,modules/gerrit/manifests/replication_key.pp,1,1.0,1,0
wikimedia_puppet,modules/mediawiki/manifests/packages/php7.pp,3,0.3333333333333333,3,0
wikimedia_puppet,modules/profile/manifests/labs/monitoring.pp,2,0.9230769230769231,2,0
wikimedia_puppet,modules/mediawiki/manifests/maintenance/purge_expired_userrights.pp,1,1.0,1,0
wikimedia_puppet,modules/etcd/manifests/v3.pp,1,1.0,1,0
wikimedia_puppet,modules/etcd/manifests/v3/monitoring.pp,1,1.0,1,0
wikimedia_puppet,modules/profile/manifests/etcd/v3.pp,1,1.0,1,0
wikimedia_puppet,modules/role/manifests/configcluster_stretch.pp,3,0.6666666666666666,3,0
wikimedia_puppet,modules/puppetmaster/manifests/ca_server.pp,1,1.0,1,0
wikimedia_puppet,modules/profile/manifests/ci/pipeline/builder.pp,1,1.0,1,0
wikimedia_puppet,modules/profile/manifests/ci/pipeline/publisher.pp,1,1.0,1,0
wikimedia_puppet,modules/role/manifests/ci/slave/labs/pipelinebuilder.pp,2,0.5,2,0
wikimedia_puppet,modules/burrow/manifests/check_consumer_lag.pp,1,1.0,1,0
wikimedia_puppet,modules/profile/manifests/kafka/mirror/alerts.pp,3,0.7058823529411765,3,0
wikimedia_puppet,modules/ntp/manifests/chrony.pp,1,1.0,1,0
wikimedia_puppet,modules/openstack/manifests/neutron/l3_agent_hacks.pp,1,1.0,1,0
wikimedia_puppet,modules/openstack/manifests/neutron/bridge.pp,2,0.6,2,0
wikimedia_puppet,modules/profile/manifests/dumps/distribution/monitoring.pp,2,0.6666666666666666,2,0
wikimedia_puppet,modules/profile/manifests/zookeeper/monitoring/server.pp,2,0.5,2,0
wikimedia_puppet,modules/profile/manifests/labs/db/views.pp,1,1.0,1,0
wikimedia_puppet,modules/profile/manifests/openstack/labtest/nodepool/service.pp,1,1.0,1,0
wikimedia_puppet,modules/role/manifests/wmcs/openstack/labtest/nodepool.pp,1,1.0,1,0
wikimedia_puppet,modules/profile/manifests/installserver/tftp.pp,1,1.0,1,0
wikimedia_puppet,modules/profile/manifests/mariadb/sanitarium_multiinstance.pp,1,1.0,1,0
wikimedia_puppet,modules/profile/manifests/lvs/interface_tweaks.pp,3,0.3333333333333333,3,0
wikimedia_puppet,modules/mediawiki/manifests/maintenance/initsitestats.pp,2,0.5,2,0
wikimedia_puppet,modules/dumps/manifests/web/fetches/stat_dumps.pp,1,1.0,1,0
wikimedia_puppet,modules/profile/manifests/analytics/data/sanitization.pp,1,1.0,1,0
wikimedia_puppet,modules/profile/manifests/installserver/dhcp.pp,1,1.0,1,0
wikimedia_puppet,modules/profile/manifests/installserver/http.pp,1,1.0,1,0
wikimedia_puppet,modules/profile/manifests/installserver/preseed.pp,1,1.0,1,0
wikimedia_puppet,modules/profile/manifests/installserver/proxy.pp,1,1.0,1,0
wikimedia_puppet,modules/profile/manifests/aptrepo/wikimedia.pp,1,1.0,1,0
wikimedia_puppet,modules/osm/manifests/populate_admin.pp,2,0.6666666666666666,2,0
wikimedia_puppet,modules/varnish/manifests/trusted_proxies.pp,1,1.0,1,0
wikimedia_puppet,modules/mcrouter/manifests/init.pp,1,1.0,1,0
wikimedia_puppet,modules/mcrouter/manifests/monitoring.pp,1,1.0,1,0
wikimedia_puppet,modules/profile/manifests/mediawiki/mcrouter_wancache.pp,1,1.0,1,0
wikimedia_puppet,modules/helm/manifests/init.pp,1,1.0,1,0
wikimedia_puppet,modules/role/manifests/mariadb/backups_and_dbstore_multiinstance.pp,1,1.0,1,0
wikimedia_puppet,modules/profile/manifests/ping_offload.pp,1,1.0,1,0
wikimedia_puppet,modules/role/manifests/ping_offload.pp,1,1.0,1,0
wikimedia_puppet,modules/role/manifests/kafka/analytics_a.pp,3,0.5,3,0
wikimedia_puppet,modules/role/manifests/kafka/analytics_b.pp,3,0.5,3,0
wikimedia_puppet,modules/openstack/manifests/jessie_mitaka_pinning.pp,2,0.5,2,0
wikimedia_puppet,modules/profile/manifests/releases/parsoid.pp,2,0.75,2,0
wikimedia_puppet,modules/base/manifests/disable_atop.pp,1,1.0,1,0
wikimedia_puppet,modules/profile/manifests/hadoop/monitoring/journalnode.pp,3,0.3333333333333333,3,0
wikimedia_puppet,modules/openstack/manifests/clientrepo.pp,2,0.75,2,0
wikimedia_puppet,modules/openstack/manifests/jessie_mitaka_client_pinning.pp,2,0.5,2,0
wikimedia_puppet,modules/dumps/manifests/web/fetches/phab.pp,2,0.5,2,0
wikimedia_puppet,modules/profile/manifests/prometheus/mcrouter_exporter.pp,3,0.3333333333333333,3,0
wikimedia_puppet,modules/prometheus/manifests/mcrouter_exporter.pp,1,1.0,1,0
wikimedia_puppet,modules/profile/manifests/dumps/generation/worker/crontester.pp,1,1.0,1,0
wikimedia_puppet,modules/geoip/manifests/data/archive.pp,1,1.0,1,0
wikimedia_puppet,modules/coal/manifests/common.pp,1,1.0,1,0
wikimedia_puppet,modules/coal/manifests/processor.pp,4,0.4,4,0
wikimedia_puppet,modules/coal/manifests/web.pp,7,0.25,7,0
wikimedia_puppet,modules/monitoring/manifests/alerts/http_availability.pp,1,1.0,1,0
wikimedia_puppet,modules/profile/manifests/tendril/maintenance.pp,1,1.0,1,0
wikimedia_puppet,modules/profile/manifests/analytics/refinery/job/data_purge.pp,7,0.3181818181818182,4,3
wikimedia_puppet,modules/profile/manifests/druid/turnilo.pp,2,0.6666666666666666,2,0
wikimedia_puppet,modules/statistics/manifests/sites/turnilo.pp,2,0.5,2,0
wikimedia_puppet,modules/turnilo/manifests/init.pp,1,1.0,1,0
wikimedia_puppet,modules/profile/manifests/proton.pp,2,0.5,2,0
wikimedia_puppet,modules/role/manifests/proton.pp,3,0.3333333333333333,3,0
wikimedia_puppet,modules/role/manifests/wdqs/internal.pp,1,1.0,1,0
wikimedia_puppet,modules/role/manifests/wdqs/test.pp,1,1.0,1,0
wikimedia_puppet,modules/profile/manifests/webperf/xhgui.pp,3,0.3333333333333333,3,0
wikimedia_puppet,modules/role/manifests/webperf/profiling_tools.pp,4,0.5,4,0
wikimedia_puppet,modules/mcrouter/types/ssl.pp,1,1.0,1,0
wikimedia_puppet,modules/toollabs/manifests/mono_external_repo.pp,1,1.0,1,0
wikimedia_puppet,modules/profile/manifests/mariadb/ferm_wmcs_on_port_3325.pp,1,1.0,1,0
wikimedia_puppet,modules/profile/manifests/mariadb/misc/multiinstance.pp,2,0.6666666666666666,2,0
wikimedia_puppet,modules/role/manifests/mariadb/misc/multiinstance.pp,2,0.5,2,0
wikimedia_puppet,modules/dumps/manifests/generation/server/jobswatcher.pp,1,1.0,1,0
wikimedia_puppet,modules/profile/manifests/dumps/generation/server/jobswatcher.pp,1,1.0,1,0
wikimedia_puppet,modules/profile/functions/mcrouter_pools.pp,1,1.0,1,0
wikimedia_puppet,modules/role/manifests/dumps/generation/worker/dumper_misc_crons_only.pp,1,1.0,1,0
wikimedia_puppet,modules/profile/manifests/debmonitor/server.pp,4,0.5,4,0
wikimedia_puppet,modules/role/manifests/debmonitor/server.pp,1,1.0,1,0
wikimedia_puppet,modules/profile/manifests/mail/mx.pp,1,1.0,1,0
wikimedia_puppet,modules/cergen/manifests/mcrouter_ca.pp,1,1.0,1,0
wikimedia_puppet,modules/profile/manifests/webperf/processors_and_site.pp,2,0.5,2,0
wikimedia_puppet,modules/role/manifests/webperf/processors_and_site.pp,2,0.5,2,0
wikimedia_puppet,modules/lvm/manifests/physical_volume.pp,1,1.0,1,0
wikimedia_puppet,modules/profile/manifests/mediawiki/videoscaler.pp,2,0.6666666666666666,2,0
wikimedia_puppet,modules/prometheus/manifests/node_intel_microcode.pp,1,1.0,1,0
wikimedia_puppet,modules/profile/manifests/analytics/cluster/packages/common.pp,3,0.6,3,0
wikimedia_puppet,modules/profile/manifests/analytics/cluster/packages/hadoop.pp,1,1.0,1,0
wikimedia_puppet,modules/profile/manifests/analytics/cluster/packages/statistics.pp,3,0.6,3,0
wikimedia_puppet,modules/profile/manifests/planet.pp,2,0.5,2,0
wikimedia_puppet,modules/profile/manifests/openstack/eqiad1/clientlib.pp,1,1.0,1,0
wikimedia_puppet,modules/profile/manifests/openstack/eqiad1/keystone/bootstrap.pp,1,1.0,1,0
wikimedia_puppet,modules/profile/manifests/openstack/eqiad1/keystone/service.pp,3,0.5384615384615384,3,0
wikimedia_puppet,modules/profile/manifests/openstack/eqiad1/observerenv.pp,2,0.5,2,0
wikimedia_puppet,modules/profile/manifests/openstack/eqiad1/rabbitmq.pp,2,0.6666666666666666,2,0
wikimedia_puppet,modules/role/manifests/wmcs/openstack/eqiad1/control.pp,2,0.8461538461538461,2,0
wikimedia_puppet,modules/profile/manifests/debmonitor/client.pp,3,0.6666666666666666,3,0
wikimedia_puppet,modules/systemd/manifests/timer.pp,3,0.3333333333333333,3,0
wikimedia_puppet,modules/systemd/types/timer/interval.pp,1,1.0,1,0
wikimedia_puppet,modules/systemd/types/timer/schedule.pp,2,0.75,2,0
wikimedia_puppet,modules/systemd/types/timer/start.pp,1,1.0,1,0
wikimedia_puppet,modules/icinga/manifests/monitor/traffic.pp,1,1.0,1,0
wikimedia_puppet,environments/production/modules/varnishkafka/manifests/init.pp,1,1.0,1,0
wikimedia_puppet,environments/production/modules/varnishkafka/manifests/instance.pp,1,1.0,1,0
wikimedia_puppet,environments/production/modules/varnishkafka/manifests/monitor/ganglia.pp,1,1.0,1,0
wikimedia_puppet,environments/production/modules/varnishkafka/manifests/monitor/statsd.pp,1,1.0,1,0
wikimedia_puppet,modules/varnishkafka/manifests/init.pp,2,0.5,2,0
wikimedia_puppet,modules/varnishkafka/manifests/instance.pp,2,0.5,2,0
wikimedia_puppet,modules/varnishkafka/manifests/monitor/ganglia.pp,1,1.0,1,0
wikimedia_puppet,modules/varnishkafka/manifests/monitor/statsd.pp,1,1.0,1,0
wikimedia_puppet,modules/profile/manifests/ci/kubernetes_config.pp,1,1.0,1,0
wikimedia_puppet,environments/production/modules/jmxtrans/manifests/init.pp,1,1.0,1,0
wikimedia_puppet,environments/production/modules/jmxtrans/manifests/metrics.pp,1,1.0,1,0
wikimedia_puppet,environments/production/modules/jmxtrans/manifests/metrics/jvm.pp,1,1.0,1,0
wikimedia_puppet,environments/production/modules/kafkatee/manifests/init.pp,1,1.0,1,0
wikimedia_puppet,environments/production/modules/kafkatee/manifests/instance.pp,1,1.0,1,0
wikimedia_puppet,environments/production/modules/kafkatee/manifests/output.pp,1,1.0,1,0
wikimedia_puppet,modules/jmxtrans/manifests/init.pp,1,1.0,1,0
wikimedia_puppet,modules/jmxtrans/manifests/metrics.pp,1,1.0,1,0
wikimedia_puppet,modules/jmxtrans/manifests/metrics/jvm.pp,1,1.0,1,0
wikimedia_puppet,modules/kafkatee/manifests/instance.pp,1,1.0,1,0
wikimedia_puppet,modules/role/manifests/wmcs/openstack/eqiad1/net.pp,3,0.6,3,0
wikimedia_puppet,modules/profile/manifests/openstack/eqiad1/neutron/common.pp,4,0.5,4,0
wikimedia_puppet,modules/profile/manifests/openstack/eqiad1/neutron/service.pp,1,1.0,1,0
wikimedia_puppet,modules/profile/manifests/openstack/eqiad1/glance.pp,3,0.5,3,0
wikimedia_puppet,modules/matomo/manifests/init.pp,2,0.5,2,0
wikimedia_puppet,modules/profile/manifests/openstack/eqiad1/neutron/l3_agent.pp,2,0.75,2,0
wikimedia_puppet,modules/profile/manifests/cache/kafka/alerts.pp,4,0.25,4,0
wikimedia_puppet,modules/profile/manifests/openstack/eqiad1/nova/common.pp,2,0.6666666666666666,2,0
wikimedia_puppet,modules/profile/manifests/openstack/eqiad1/nova/conductor/service.pp,1,1.0,1,0
wikimedia_puppet,modules/profile/manifests/openstack/eqiad1/nova/scheduler/service.pp,1,1.0,1,0
wikimedia_puppet,modules/profile/manifests/openstack/eqiad1/nova/api/service.pp,2,0.5,2,0
wikimedia_puppet,modules/mediawiki/manifests/web/site.pp,1,1.0,1,0
wikimedia_puppet,modules/contint/manifests/packages/php5.pp,1,1.0,1,0
wikimedia_puppet,environments/mediawiki_test/modules/mediawiki_exp/manifests/web/prod_sites.pp,2,0.9230769230769231,2,0
wikimedia_puppet,environments/mediawiki_test/modules/mediawiki_exp/manifests/web/site.pp,1,1.0,1,0
wikimedia_puppet,modules/profile/manifests/openstack/eqiad1/neutron/dhcp_agent.pp,1,1.0,1,0
wikimedia_puppet,modules/profile/manifests/analytics/refinery/repository.pp,2,0.5,2,0
wikimedia_puppet,modules/role/manifests/wmcs/openstack/eqiad1/virt.pp,1,1.0,1,0
wikimedia_puppet,modules/profile/manifests/openstack/eqiad1/nova/compute/service.pp,1,1.0,1,0
wikimedia_puppet,modules/profile/manifests/openstack/eqiad1/neutron/metadata_agent.pp,2,0.5,2,0
wikimedia_puppet,modules/profile/manifests/analytics/cluster/gitconfig.pp,1,1.0,1,0
wikimedia_puppet,modules/profile/manifests/mediawiki/web_testing.pp,1,1.0,1,0
wikimedia_puppet,modules/git/manifests/systemconfig.pp,1,1.0,1,0
wikimedia_puppet,modules/profile/manifests/puppetmaster/updatenetboot.pp,1,1.0,1,0
wikimedia_puppet,modules/profile/manifests/openstack/labtestn/pdns/dns_floating_ip_updater.pp,1,1.0,1,0
wikimedia_puppet,modules/profile/manifests/openstack/labtestn/pdns/recursor/service.pp,1,1.0,1,0
wikimedia_puppet,modules/snapshot/manifests/dumps/timechecker.pp,1,1.0,1,0
wikimedia_puppet,modules/dumps/manifests/generation/server/statsender.pp,1,1.0,1,0
wikimedia_puppet,modules/profile/manifests/dumps/generation/server/statsender.pp,1,1.0,1,0
wikimedia_puppet,modules/toollabs/manifests/genpp/python_exec_stretch.pp,1,1.0,1,0
wikimedia_puppet,modules/profile/manifests/archiva.pp,2,0.8,2,0
wikimedia_puppet,modules/dbtree/manifests/init.pp,4,0.25,4,0
wikimedia_puppet,modules/elasticsearch/manifests/log/hot_threads_cluster.pp,1,1.0,1,0
wikimedia_puppet,modules/profile/manifests/elasticsearch/cirrus.pp,1,1.0,1,0
wikimedia_puppet,modules/haproxy/manifests/site.pp,1,1.0,1,0
wikimedia_puppet,modules/postgresql/manifests/backup.pp,3,0.6666666666666666,3,0
wikimedia_puppet,modules/interface/manifests/route.pp,2,0.5,2,0
wikimedia_puppet,modules/prometheus/manifests/resource_config.pp,1,1.0,1,0
wikimedia_puppet,modules/tilerator/manifests/regen.pp,2,0.8333333333333334,2,0
wikimedia_puppet,modules/profile/manifests/archiva/proxy.pp,2,0.6,2,0
wikimedia_puppet,modules/mariadb/manifests/monitor_readonly.pp,1,1.0,1,0
wikimedia_puppet,modules/mediawiki/manifests/web/vhost.pp,1,1.0,1,0
wikimedia_puppet,modules/mediawiki/types/rewrites.pp,1,1.0,1,0
wikimedia_puppet,modules/profile/manifests/openstack/eqiad1/designate/service.pp,3,0.4,3,0
wikimedia_puppet,modules/profile/manifests/openstack/eqiad1/pdns/auth/db.pp,1,1.0,1,0
wikimedia_puppet,modules/profile/manifests/openstack/eqiad1/pdns/auth/service.pp,1,1.0,1,0
wikimedia_puppet,modules/profile/manifests/openstack/eqiad1/pdns/dns_floating_ip_updater.pp,1,1.0,1,0
wikimedia_puppet,modules/profile/manifests/openstack/eqiad1/pdns/recursor/primary.pp,1,1.0,1,0
wikimedia_puppet,modules/profile/manifests/openstack/eqiad1/pdns/recursor/secondary.pp,1,1.0,1,0
wikimedia_puppet,modules/profile/manifests/openstack/eqiad1/pdns/recursor/service.pp,1,1.0,1,0
wikimedia_puppet,modules/role/manifests/wmcs/openstack/eqiad1/services_primary.pp,1,1.0,1,0
wikimedia_puppet,modules/role/manifests/wmcs/openstack/eqiad1/services_secondary.pp,1,1.0,1,0
wikimedia_puppet,modules/profile/manifests/openstack/eqiad1/cloudrepo.pp,1,1.0,1,0
wikimedia_puppet,modules/profile/manifests/webperf/coal_web.pp,1,1.0,1,0
wikimedia_puppet,modules/profile/manifests/webperf/processors.pp,1,1.0,1,0
wikimedia_puppet,modules/profile/manifests/webperf/site.pp,3,0.6,3,0
wikimedia_puppet,modules/profile/manifests/webperf/xenon.pp,1,1.0,1,0
wikimedia_puppet,modules/profile/manifests/prometheus/logstash_exporter.pp,1,1.0,1,0
wikimedia_puppet,modules/prometheus/manifests/logstash_exporter.pp,1,1.0,1,0
wikimedia_puppet,modules/profile/manifests/netbox/httpd.pp,1,1.0,1,0
wikimedia_puppet,modules/profile/manifests/trafficserver/backend.pp,2,0.7777777777777778,2,0
wikimedia_puppet,modules/role/manifests/trafficserver/backend.pp,1,1.0,1,0
wikimedia_puppet,modules/trafficserver/manifests/init.pp,2,0.5,2,0
wikimedia_puppet,modules/trafficserver/types/mapping_rule.pp,1,1.0,1,0
wikimedia_puppet,modules/profile/manifests/mjolnir.pp,1,1.0,1,0
wikimedia_puppet,modules/profile/manifests/mjolnir/kafka_bulk_daemon.pp,1,1.0,1,0
wikimedia_puppet,modules/profile/manifests/mjolnir/kafka_msearch_daemon.pp,1,1.0,1,0
wikimedia_puppet,modules/profile/manifests/microsites/sitemaps.pp,3,0.3333333333333333,3,0
wikimedia_puppet,modules/arclamp/manifests/init.pp,1,1.0,1,0
wikimedia_puppet,modules/profile/manifests/webperf/arclamp.pp,1,1.0,1,0
wikimedia_puppet,modules/trafficserver/manifests/lua_script.pp,1,1.0,1,0
wikimedia_puppet,modules/systemd/types/timer/datetime.pp,2,0.6666666666666666,2,0
wikimedia_puppet,modules/trafficserver/types/storage_element.pp,1,1.0,1,0
wikimedia_puppet,modules/trafficserver/types/caching_rule.pp,1,1.0,1,0
wikimedia_puppet,modules/profile/manifests/tendril/webserver.pp,3,0.3333333333333333,3,0
wikimedia_puppet,modules/contint/manifests/packages/mediawiki.pp,1,1.0,1,0
wikimedia_puppet,modules/role/manifests/analytics_cluster/turnilo.pp,1,1.0,1,0
wikimedia_puppet,modules/php/manifests/default_extensions.pp,1,1.0,1,0
wikimedia_puppet,modules/php/manifests/extension.pp,1,1.0,1,0
wikimedia_puppet,modules/php/manifests/init.pp,1,1.0,1,0
wikimedia_puppet,modules/php/types/sapi.pp,1,1.0,1,0
wikimedia_puppet,modules/prometheus/manifests/trafficserver_exporter.pp,1,1.0,1,0
wikimedia_puppet,modules/wmflib/types/useripport.pp,1,1.0,1,0
wikimedia_puppet,modules/elasticsearch/manifests/tlsproxy.pp,1,1.0,1,0
wikimedia_puppet,modules/turnilo/manifests/proxy.pp,1,1.0,1,0
wikimedia_puppet,modules/profile/manifests/quarry/database.pp,2,0.6666666666666666,2,0
wikimedia_puppet,modules/profile/manifests/quarry/web.pp,2,0.75,2,0
wikimedia_puppet,modules/role/manifests/analytics_cluster/superset.pp,1,1.0,1,0
wikimedia_puppet,modules/profile/manifests/quarry/base.pp,2,0.5,2,0
wikimedia_puppet,modules/profile/manifests/quarry/redis.pp,1,1.0,1,0
wikimedia_puppet,modules/profile/manifests/quarry/celeryrunner.pp,2,0.75,2,0
wikimedia_puppet,modules/profile/manifests/quarry/querykiller.pp,2,0.6666666666666666,2,0
wikimedia_puppet,modules/profile/manifests/hadoop/sites/yarn.pp,1,1.0,1,0
wikimedia_puppet,modules/role/manifests/analytics_cluster/hadoop/ui.pp,1,1.0,1,0
wikimedia_puppet,modules/profile/manifests/hadoop/yarn_proxy.pp,2,0.6666666666666666,2,0
wikimedia_puppet,modules/mariadb/manifests/stock_heartbeat.pp,1,1.0,1,0
wikimedia_puppet,modules/profile/manifests/mariadb/beta.pp,1,1.0,1,0
wikimedia_puppet,modules/monitoring/manifests/alerts/traffic_drop.pp,1,1.0,1,0
wikimedia_puppet,modules/profile/manifests/spicerack.pp,2,0.6666666666666666,2,0
wikimedia_puppet,modules/profile/manifests/analytics/systemd_timer.pp,2,0.7142857142857143,2,0
wikimedia_puppet,modules/profile/manifests/icinga.pp,5,0.47058823529411764,5,0
wikimedia_puppet,modules/mediawiki/functions/state.pp,1,1.0,1,0
wikimedia_puppet,modules/profile/manifests/conftool/state.pp,1,1.0,1,0
wikimedia_puppet,modules/profile/manifests/poolcounter.pp,1,1.0,1,0
wikimedia_puppet,modules/role/manifests/orespoolcounter.pp,1,1.0,1,0
wikimedia_puppet,modules/profile/manifests/analytics/refinery/job/config.pp,1,1.0,1,0
wikimedia_puppet,modules/profile/manifests/ci/dockervolume.pp,1,1.0,1,0
wikimedia_puppet,modules/snmp/manifests/init.pp,2,0.5,2,0
wikimedia_puppet,modules/snmp/manifests/mibs.pp,1,1.0,1,0
wikimedia_puppet,modules/snmp/manifests/mibs/source.pp,1,1.0,1,0
wikimedia_puppet,modules/profile/manifests/parsoid/diffserver.pp,1,1.0,1,0
wikimedia_puppet,modules/profile/manifests/parsoid/rt_client.pp,1,1.0,1,0
wikimedia_puppet,modules/profile/manifests/parsoid/rt_server.pp,1,1.0,1,0
wikimedia_puppet,modules/profile/manifests/parsoid/vd_client.pp,1,1.0,1,0
wikimedia_puppet,modules/profile/manifests/parsoid/vd_server.pp,1,1.0,1,0
wikimedia_puppet,modules/profile/manifests/prometheus/haproxy_exporter.pp,1,1.0,1,0
wikimedia_puppet,modules/prometheus/manifests/haproxy_exporter.pp,1,1.0,1,0
wikimedia_puppet,modules/dumps/manifests/monitoring.pp,1,1.0,1,0
wikimedia_puppet,modules/profile/manifests/releases/common.pp,2,0.6666666666666666,2,0
wikimedia_puppet,modules/profile/manifests/elasticsearch/logstash.pp,1,1.0,1,0
wikimedia_puppet,modules/prometheus/manifests/elasticsearch_exporter/common.pp,1,1.0,1,0
wikimedia_puppet,modules/prometheus/manifests/wmf_elasticsearch_exporter/common.pp,1,1.0,1,0
wikimedia_puppet,modules/profile/manifests/analytics/refinery/job/spark_job.pp,1,1.0,1,0
wikimedia_puppet,modules/profile/manifests/mediawiki/php.pp,1,1.0,1,0
wikimedia_puppet,modules/elasticsearch/manifests/instance.pp,1,1.0,1,0
wikimedia_puppet,modules/elasticsearch/types/instanceparams.pp,1,1.0,1,0
wikimedia_puppet,modules/profile/manifests/icinga/ircbot.pp,2,0.6666666666666666,2,0
wikimedia_puppet,modules/php/manifests/fpm.pp,1,1.0,1,0
wikimedia_puppet,modules/php/manifests/fpm/pool.pp,1,1.0,1,0
wikimedia_puppet,modules/mariadb/manifests/monitor_backup.pp,1,1.0,1,0
wikimedia_puppet,modules/profile/manifests/mariadb/backup/check.pp,1,1.0,1,0
wikimedia_puppet,modules/role/manifests/mariadb/misc/tendril_and_zarcillo.pp,1,1.0,1,0
wikimedia_puppet,modules/profile/manifests/elasticsearch/toolforge.pp,1,1.0,1,0
wikimedia_puppet,modules/profile/manifests/openstack/base/metrics.pp,1,1.0,1,0
wikimedia_puppet,modules/profile/manifests/openstack/eqiad1/metrics.pp,1,1.0,1,0
wikimedia_puppet,modules/profile/manifests/prometheus/openstack_exporter.pp,1,1.0,1,0
wikimedia_puppet,modules/profile/manifests/product_analytics/base.pp,2,0.5,2,0
wikimedia_puppet,modules/profile/manifests/product_analytics/deep_learning.pp,1,1.0,1,0
wikimedia_puppet,modules/profile/manifests/product_analytics/forecasting.pp,1,1.0,1,0
wikimedia_puppet,modules/profile/manifests/product_analytics/machine_learning.pp,1,1.0,1,0
wikimedia_puppet,modules/profile/manifests/product_analytics/probabilistic_programming.pp,1,1.0,1,0
wikimedia_puppet,modules/role/manifests/product_analytics/allstar_cruncher.pp,1,1.0,1,0
wikimedia_puppet,modules/role/manifests/product_analytics/bayes.pp,1,1.0,1,0
wikimedia_puppet,modules/role/manifests/product_analytics/deep_learner.pp,1,1.0,1,0
wikimedia_puppet,modules/role/manifests/product_analytics/forecaster.pp,1,1.0,1,0
wikimedia_puppet,modules/role/manifests/product_analytics/learner.pp,1,1.0,1,0
wikimedia_puppet,modules/profile/manifests/certspotter.pp,1,1.0,1,0
wikimedia_puppet,modules/profile/manifests/lvs/realserver.pp,1,1.0,1,0
wikimedia_puppet,modules/profile/manifests/parsoid.pp,2,0.75,2,0
wikimedia_puppet,modules/profile/manifests/labs/db/kill_long_running_queries.pp,2,0.75,2,0
wikimedia_puppet,modules/profile/manifests/labs/db/wikireplica.pp,1,1.0,1,0
wikimedia_puppet,modules/role/manifests/labs/db/wikireplica_analytics.pp,1,1.0,1,0
wikimedia_puppet,modules/role/manifests/labs/db/wikireplica_web.pp,1,1.0,1,0
wikimedia_puppet,modules/mediawiki/types/upload_rewrite.pp,1,1.0,1,0
wikimedia_puppet,modules/cumin/manifests/selector.pp,1,1.0,1,0
wikimedia_puppet,modules/profile/manifests/wdqs/autodeploy.pp,1,1.0,1,0
wikimedia_puppet,modules/role/manifests/wdqs/autodeploy.pp,1,1.0,1,0
wikimedia_puppet,modules/wdqs/manifests/autodeploy.pp,1,1.0,1,0
wikimedia_puppet,modules/varnish/manifests/logging/backendtiming.pp,2,0.5,2,0
wikimedia_puppet,modules/profile/manifests/toolforge/apt_pinning.pp,1,1.0,1,0
wikimedia_puppet,modules/profile/manifests/toolforge/genpp/python_dev_jessie.pp,1,1.0,1,0
wikimedia_puppet,modules/profile/manifests/toolforge/genpp/python_dev_stretch.pp,1,1.0,1,0
wikimedia_puppet,modules/profile/manifests/toolforge/genpp/python_dev_trusty.pp,1,1.0,1,0
wikimedia_puppet,modules/profile/manifests/toolforge/genpp/python_exec_jessie.pp,1,1.0,1,0
wikimedia_puppet,modules/profile/manifests/toolforge/genpp/python_exec_stretch.pp,1,1.0,1,0
wikimedia_puppet,modules/profile/manifests/toolforge/genpp/python_exec_trusty.pp,1,1.0,1,0
wikimedia_puppet,modules/profile/manifests/toolforge/grid/base.pp,1,1.0,1,0
wikimedia_puppet,modules/profile/manifests/toolforge/grid/compute.pp,1,1.0,1,0
wikimedia_puppet,modules/profile/manifests/toolforge/grid/exec_environ.pp,1,1.0,1,0
wikimedia_puppet,modules/profile/manifests/toolforge/grid/hba.pp,1,1.0,1,0
wikimedia_puppet,modules/profile/manifests/toolforge/grid/master.pp,1,1.0,1,0
wikimedia_puppet,modules/profile/manifests/toolforge/grid/node/compute/general.pp,1,1.0,1,0
wikimedia_puppet,modules/profile/manifests/toolforge/grid/node/web.pp,1,1.0,1,0
wikimedia_puppet,modules/profile/manifests/toolforge/grid/node/web/generic.pp,1,1.0,1,0
wikimedia_puppet,modules/profile/manifests/toolforge/grid/node/web/lighttpd.pp,1,1.0,1,0
wikimedia_puppet,modules/profile/manifests/toolforge/infrastructure.pp,1,1.0,1,0
wikimedia_puppet,modules/sonofgridengine/manifests/admin_host.pp,1,1.0,1,0
wikimedia_puppet,modules/sonofgridengine/manifests/collector.pp,1,1.0,1,0
wikimedia_puppet,modules/sonofgridengine/manifests/collectors/hostgroups.pp,1,1.0,1,0
wikimedia_puppet,modules/sonofgridengine/manifests/collectors/queues.pp,1,1.0,1,0
wikimedia_puppet,modules/sonofgridengine/manifests/exec_host.pp,1,1.0,1,0
wikimedia_puppet,modules/sonofgridengine/manifests/hostgroup.pp,1,1.0,1,0
wikimedia_puppet,modules/sonofgridengine/manifests/init.pp,1,1.0,1,0
wikimedia_puppet,modules/sonofgridengine/manifests/join.pp,1,1.0,1,0
wikimedia_puppet,modules/sonofgridengine/manifests/master.pp,1,1.0,1,0
wikimedia_puppet,modules/sonofgridengine/manifests/queue.pp,1,1.0,1,0
wikimedia_puppet,modules/sonofgridengine/manifests/resource.pp,1,1.0,1,0
wikimedia_puppet,modules/sonofgridengine/manifests/resourcedir.pp,1,1.0,1,0
wikimedia_puppet,modules/sonofgridengine/manifests/shadow_master.pp,1,1.0,1,0
wikimedia_puppet,modules/sonofgridengine/manifests/submit_host.pp,1,1.0,1,0
wikimedia_puppet,modules/profile/manifests/prometheus/statsd_exporter.pp,1,1.0,1,0
wikimedia_puppet,modules/prometheus/manifests/statsd_exporter.pp,1,1.0,1,0
wikimedia_puppet,modules/wdqs/manifests/deploy/autodeploy.pp,1,1.0,1,0
wikimedia_puppet,modules/wdqs/manifests/deploy/manual.pp,2,0.5,2,0
wikimedia_puppet,modules/wdqs/manifests/deploy/scap.pp,1,1.0,1,0
wikimedia_puppet,modules/certcentral/manifests/cert.pp,1,1.0,1,0
wikimedia_puppet,modules/certcentral/manifests/server.pp,2,0.6666666666666666,2,0
wikimedia_puppet,modules/profile/manifests/certcentral.pp,1,1.0,1,0
wikimedia_puppet,modules/role/manifests/certcentral.pp,1,1.0,1,0
wikimedia_puppet,modules/role/manifests/kafka/logging.pp,1,1.0,1,0
wikimedia_puppet,modules/profile/manifests/analytics/cluster/druid_deep_storage.pp,1,1.0,1,0
wikimedia_puppet,modules/profile/manifests/mail/smarthost.pp,1,1.0,1,0
wikimedia_puppet,modules/role/manifests/mail/smarthost/wmcs.pp,1,1.0,1,0
wikimedia_puppet,modules/profile/manifests/authdns/certcentral_target.pp,2,0.5,2,0
wikimedia_puppet,modules/wdqs/types/deploymode.pp,1,1.0,1,0
wikimedia_puppet,modules/profile/manifests/analytics/refinery/job/druid_load.pp,1,1.0,1,0
wikimedia_puppet,modules/profile/manifests/analytics/refinery/job/eventlogging_to_druid_job.pp,2,0.5,2,0
wikimedia_translatewiki,puppet/modules/nginx/manifests/init.pp,6,0.6521739130434783,3,3
wikimedia_translatewiki,puppet/modules/php/manifests/init.pp,3,0.8,3,0
wikimedia_translatewiki,puppet/modules/puppet/manifests/init.pp,4,0.4,4,0
wikimedia_translatewiki,puppet/site.pp,5,0.6122448979591837,3,2
wikimedia_translatewiki,puppet/modules/memcached/manifests/init.pp,2,0.5,2,0
wikimedia_translatewiki,puppet/modules/base/manifests/init.pp,3,0.5769230769230769,3,0
wikimedia_translatewiki,puppet/modules/mariadb/manifests/init.pp,6,0.45454545454545453,2,4
wikimedia_translatewiki,puppet/modules/users/manifests/init.pp,7,0.3684210526315789,7,0
wikimedia_translatewiki,puppet/modules/sudo/manifests/init.pp,2,0.5,2,0
wikimedia_translatewiki,puppet/modules/exim-conf/manifests/init.pp,1,1.0,1,0
wikimedia_translatewiki,puppet/modules/logrotate/manifests/init.pp,2,0.75,2,0
wikimedia_translatewiki,puppet/modules/wiki/manifests/init.pp,3,0.5,3,0
wikimedia_translatewiki,puppet/modules/fcgiwrap/manifests/init.pp,2,0.5,2,0
wikimedia_translatewiki,puppet/modules/backup/manifests/init.pp,4,0.5,4,0
wikimedia_translatewiki,puppet/modules/mailman-conf/manifests/init.pp,4,0.5,4,0
wikimedia_translatewiki,puppet/modules/awstats/manifests/init.pp,2,0.6666666666666666,2,0
wikimedia_translatewiki,puppet/modules/ssh-conf/manifests/init.pp,2,0.6666666666666666,2,0
wikimedia_translatewiki,puppet/modules/translationmemory/manifests/init.pp,1,1.0,1,0
wikimedia_translatewiki,puppet/modules/hhvm/manifests/init.pp,4,0.6,4,0
wikimedia_translatewiki,puppet/modules/kitano-nl/manifests/init.pp,2,0.5,2,0
wikimedia_translatewiki,puppet/modules/profile/manifests/mwelasticsearch.pp,6,0.4444444444444444,6,0
wikimedia_translatewiki,puppet/modules/sshd/manifests/init.pp,2,0.5,2,0
wikimedia_translatewiki,puppet/modules/base/manifests/mediawiki.pp,2,0.6666666666666666,2,0
wikimedia_translatewiki,puppet/modules/base/manifests/vcs.pp,2,0.6666666666666666,2,0
wikimedia_translatewiki,puppet/modules/base/manifests/es.pp,1,1.0,1,0
wikimedia_translatewiki,puppet/modules/base/manifests/web1.pp,1,1.0,1,0
wikimedia_translatewiki,puppet/modules/nginx/manifests/sites.pp,2,0.8333333333333334,2,0
wikimedia_translatewiki,puppet/modules/nginx/manifests/ssl.pp,3,0.7142857142857143,3,0
wikimedia_translatewiki,puppet/modules/exim-conf/manifests/es.pp,1,1.0,1,0
wikimedia_translatewiki,puppet/modules/exim-conf/manifests/web1.pp,1,1.0,1,0
wikimedia_translatewiki,puppet/modules/eximconf/manifests/es.pp,3,0.3333333333333333,3,0
wikimedia_translatewiki,puppet/modules/eximconf/manifests/init.pp,3,0.5,3,0
wikimedia_translatewiki,puppet/modules/eximconf/manifests/web1.pp,3,0.3333333333333333,3,0
wikimedia_translatewiki,puppet/modules/kitanonl/manifests/init.pp,1,1.0,1,0
wikimedia_translatewiki,puppet/modules/mailmanconf/manifests/init.pp,3,0.3333333333333333,3,0
wikimedia_translatewiki,puppet/modules/hostname/manifests/init.pp,1,1.0,1,0
