Path,File,contributers,top,major,minor
wikimedia_puppet,admins.pp,62,0.10559006211180125,5,57
wikimedia_puppet,apaches.pp,14,0.18518518518518517,8,6
wikimedia_puppet,backups.pp,11,0.6666666666666666,4,7
wikimedia_puppet,base.pp,55,0.12164948453608247,4,51
wikimedia_puppet,certs.pp,22,0.17796610169491525,7,15
wikimedia_puppet,decommissioning.pp,26,0.21390374331550802,5,21
wikimedia_puppet,dns.pp,23,0.20155038759689922,5,18
wikimedia_puppet,drac.pp,3,0.5,3,0
wikimedia_puppet,exim.pp,4,0.38461538461538464,4,0
wikimedia_puppet,facilities.pp,12,0.19230769230769232,6,6
wikimedia_puppet,ganglia.pp,54,0.11670480549199085,7,47
wikimedia_puppet,generic-definitions.pp,21,0.3317307692307692,5,16
wikimedia_puppet,gerrit.pp,39,0.33620689655172414,2,37
wikimedia_puppet,imagescaler.pp,21,0.20754716981132076,7,14
wikimedia_puppet,iptables.pp,12,0.2857142857142857,6,6
wikimedia_puppet,jobrunner.pp,22,0.36220472440944884,5,17
wikimedia_puppet,ldap.pp,16,0.7054794520547946,2,14
wikimedia_puppet,lvs.pp,32,0.5730994152046783,1,31
wikimedia_puppet,media-storage.pp,5,0.42857142857142855,5,0
wikimedia_puppet,mediawiki.pp,48,0.2108626198083067,5,43
wikimedia_puppet,memcached.pp,22,0.18811881188118812,5,17
wikimedia_puppet,misc-servers.pp,28,0.1543859649122807,8,20
wikimedia_puppet,mobile.pp,18,0.28865979381443296,6,12
wikimedia_puppet,mysql.pp,27,0.3849056603773585,4,23
wikimedia_puppet,nagios.pp,27,0.3755868544600939,5,22
wikimedia_puppet,network.pp,28,0.12179487179487179,8,20
wikimedia_puppet,nfs.pp,24,0.17045454545454544,6,18
wikimedia_puppet,nrpe.pp,17,0.2647058823529412,5,12
wikimedia_puppet,ntp.pp,13,0.3902439024390244,4,9
wikimedia_puppet,openstack.pp,23,0.5301204819277109,3,20
wikimedia_puppet,owa.pp,4,0.4,4,0
wikimedia_puppet,passwords.pp,16,0.13043478260869565,6,10
wikimedia_puppet,ppa.pp,2,0.6666666666666666,2,0
wikimedia_puppet,protoproxy.pp,21,0.24742268041237114,6,15
wikimedia_puppet,puppetmaster.pp,24,0.2708333333333333,7,17
wikimedia_puppet,search.pp,23,0.36585365853658536,4,19
wikimedia_puppet,site.pp,120,0.1068011828144025,2,118
wikimedia_puppet,snapshots.pp,5,0.6666666666666666,5,0
wikimedia_puppet,squid.pp,9,0.3939393939393939,5,4
wikimedia_puppet,ssh.pp,9,0.4,9,0
wikimedia_puppet,stages.pp,8,0.23076923076923078,8,0
wikimedia_puppet,sudo.pp,15,0.34,5,10
wikimedia_puppet,svn.pp,14,0.2127659574468085,6,8
wikimedia_puppet,udpprofile.pp,8,0.125,8,0
wikimedia_puppet,varnish.pp,13,0.6891891891891891,2,11
wikimedia_puppet,mailman.pp,8,0.5,8,0
wikimedia_puppet,realm.pp,29,0.10077519379844961,7,22
wikimedia_puppet,test.pp,5,0.4444444444444444,5,0
wikimedia_puppet,swift.pp,27,0.23529411764705882,5,22
wikimedia_puppet,mail.pp,29,0.3305439330543933,4,25
wikimedia_puppet,bastion.pp,25,0.16822429906542055,8,17
wikimedia_puppet,thumbs.pp,4,0.25,4,0
wikimedia_puppet,contint.pp,18,0.6521739130434783,1,17
wikimedia_puppet,bugzilla.pp,11,0.19444444444444445,7,4
wikimedia_puppet,blogs.pp,19,0.18181818181818182,5,14
wikimedia_puppet,wikimanias.pp,1,1.0,1,0
wikimedia_puppet,outreach.pp,8,0.4375,8,0
wikimedia_puppet,wikimania.pp,3,0.3333333333333333,3,0
wikimedia_puppet,secure.pp,6,0.16666666666666666,6,0
wikimedia_puppet,planet.pp,15,0.34444444444444444,4,11
wikimedia_puppet,maintenance.pp,40,0.19444444444444445,5,35
wikimedia_puppet,wikistats.pp,9,0.425531914893617,3,6
wikimedia_puppet,logging.pp,45,0.2181208053691275,4,41
wikimedia_puppet,mariadb.pp,28,0.3643122676579926,4,24
wikimedia_puppet,db.pp,25,0.21212121212121213,7,18
wikimedia_puppet,fundraising.pp,16,0.8169934640522876,1,15
wikimedia_puppet,bots-cb.pp,2,0.5,2,0
wikimedia_puppet,firewall.pp,27,0.20408163265306123,5,22
wikimedia_puppet,cache.pp,49,0.3751284686536485,2,47
wikimedia_puppet,ipmi_mgmt.pp,1,1.0,1,0
wikimedia_puppet,webserver.pp,35,0.22289156626506024,5,30
wikimedia_puppet,management.pp,12,0.23529411764705882,8,4
wikimedia_puppet,torrus.pp,14,0.49056603773584906,3,11
wikimedia_puppet,statistics.pp,41,0.3252212389380531,4,37
wikimedia_puppet,seach.pp,1,1.0,1,0
wikimedia_puppet,analytics.pp,23,0.3793103448275862,4,19
wikimedia_puppet,install-server.pp,13,0.425,6,7
wikimedia_puppet,icinga.pp,47,0.22437673130193905,5,42
wikimedia_puppet,package-builder.pp,8,0.4,4,4
wikimedia_puppet,mwlib.pp,5,0.7894736842105263,5,0
wikimedia_puppet,lucene.pp,20,0.1590909090909091,6,14
wikimedia_puppet,deployment-host.pp,2,0.6666666666666666,2,0
wikimedia_puppet,timedmediahandler.pp,4,0.25,4,0
wikimedia_puppet,geoip.pp,9,0.4358974358974359,6,3
wikimedia_puppet,pdf.pp,7,0.4666666666666667,7,0
wikimedia_puppet,java.pp,9,0.23529411764705882,9,0
wikimedia_puppet,labs.pp,41,0.1452513966480447,8,33
wikimedia_puppet,labsmysql.pp,9,0.4375,9,0
wikimedia_puppet,labsmw.pp,2,0.8333333333333334,2,0
wikimedia_puppet,ipv6relay.pp,5,0.3333333333333333,5,0
wikimedia_puppet,labsmediawiki.pp,11,0.4722222222222222,3,8
wikimedia_puppet,miredo.pp,2,0.8,2,0
wikimedia_puppet,wikibugs.pp,8,0.3333333333333333,8,0
wikimedia_puppet,udp2log.pp,27,0.18947368421052632,8,19
wikimedia_puppet,labsdebrepo.pp,5,0.5555555555555556,5,0
wikimedia_puppet,apache.pp,25,0.1375,7,18
wikimedia_puppet,init.pp,121,0.1085972850678733,5,116
wikimedia_puppet,client.pp,35,0.1,9,26
wikimedia_puppet,server.pp,54,0.19642857142857142,3,51
wikimedia_puppet,smokeping.pp,11,0.34146341463414637,5,6
wikimedia_puppet,wlm.pp,1,1.0,1,0
wikimedia_puppet,parsoid.pp,34,0.13793103448275862,7,27
wikimedia_puppet,applicationserver.pp,23,0.30526315789473685,5,18
wikimedia_puppet,php.pp,24,0.18518518518518517,5,19
wikimedia_puppet,cron.pp,10,0.41379310344827586,4,6
wikimedia_puppet,nice.pp,2,0.5,2,0
wikimedia_puppet,packages.pp,48,0.08022922636103152,5,43
wikimedia_puppet,pybal_check.pp,6,0.3333333333333333,6,0
wikimedia_puppet,sync.pp,17,0.3283582089552239,4,13
wikimedia_puppet,syslog.pp,17,0.14285714285714285,7,10
wikimedia_puppet,conf.pp,15,0.2413793103448276,6,9
wikimedia_puppet,datadirs.pp,3,0.5,3,0
wikimedia_puppet,heartbeat.pp,4,0.4444444444444444,4,0
wikimedia_puppet,snapshot.pp,13,0.35555555555555557,4,9
wikimedia_puppet,users.pp,18,0.14545454545454545,9,9
wikimedia_puppet,rancid.pp,5,0.38095238095238093,4,1
wikimedia_puppet,service.pp,42,0.26169405815423513,5,37
wikimedia_puppet,videoscaler.pp,8,0.4,8,0
wikimedia_puppet,poolcounter.pp,10,0.2857142857142857,10,0
wikimedia_puppet,file_line.pp,2,0.5,2,0
wikimedia_puppet,glance.pp,11,0.27692307692307694,5,6
wikimedia_puppet,keystone.pp,10,0.2727272727272727,4,6
wikimedia_puppet,nova.pp,31,0.34513274336283184,3,28
wikimedia_puppet,puppet.pp,20,0.13592233009708737,8,12
wikimedia_puppet,deployment.pp,46,0.2066869300911854,4,42
wikimedia_puppet,get.pp,3,0.3333333333333333,3,0
wikimedia_puppet,repo.pp,10,0.21428571428571427,6,4
wikimedia_puppet,module.pp,10,0.18181818181818182,10,0
wikimedia_puppet,server_with_motd.pp,1,1.0,1,0
wikimedia_puppet,master.pp,48,0.12915129151291513,4,44
wikimedia_puppet,minion.pp,13,0.25925925925925924,4,9
wikimedia_puppet,salt.pp,17,0.44871794871794873,5,12
wikimedia_puppet,params.pp,16,0.20512820512820512,9,7
wikimedia_puppet,apt.pp,10,0.13333333333333333,10,0
wikimedia_puppet,yum.pp,2,0.5,2,0
wikimedia_puppet,beta.pp,25,0.21367521367521367,7,18
wikimedia_puppet,zuul.pp,13,0.6049382716049383,3,10
wikimedia_puppet,pin.pp,4,0.3333333333333333,4,0
wikimedia_puppet,repository.pp,12,0.1875,12,0
wikimedia_puppet,unattended-upgrades.pp,1,1.0,1,0
wikimedia_puppet,update.pp,5,0.2857142857142857,5,0
wikimedia_puppet,coredb.pp,16,0.41739130434782606,4,12
wikimedia_puppet,slow_digest.pp,6,0.2,6,0
wikimedia_puppet,utils.pp,8,0.3157894736842105,8,0
wikimedia_puppet,unattendedupgrades.pp,5,0.4666666666666667,5,0
wikimedia_puppet,racktables.pp,17,0.24489795918367346,6,11
wikimedia_puppet,rt-server.pp,5,0.3333333333333333,5,0
wikimedia_puppet,download.pp,11,0.5294117647058824,5,6
wikimedia_puppet,irc.pp,8,0.2,8,0
wikimedia_puppet,etherpad.pp,14,0.390625,4,10
wikimedia_puppet,graphite.pp,31,0.20833333333333334,4,27
wikimedia_puppet,wikidata.pp,22,0.175,7,15
wikimedia_puppet,openjdk.pp,2,0.6666666666666666,2,0
wikimedia_puppet,mirror.pp,13,0.6129032258064516,3,10
wikimedia_puppet,deployment_server.pp,15,0.3888888888888889,5,10
wikimedia_puppet,salt_master.pp,8,0.6904761904761905,2,6
wikimedia_puppet,master_environment.pp,4,0.7,4,0
wikimedia_puppet,noc.pp,10,0.3157894736842105,10,0
wikimedia_puppet,limesurvey.pp,2,0.5,2,0
wikimedia_puppet,deployment_repo_sync_hook_link.pp,1,1.0,1,0
wikimedia_puppet,images.pp,5,0.2857142857142857,5,0
wikimedia_puppet,noupgrade.pp,2,0.5,2,0
wikimedia_puppet,dev.pp,6,0.25,6,0
wikimedia_puppet,mod.pp,12,0.25,6,6
wikimedia_puppet,auth_basic.pp,2,0.5,2,0
wikimedia_puppet,auth_kerb.pp,2,0.5,2,0
wikimedia_puppet,cgi.pp,2,0.5,2,0
wikimedia_puppet,dav.pp,2,0.5,2,0
wikimedia_puppet,dav_fs.pp,2,0.5,2,0
wikimedia_puppet,default.pp,7,0.2727272727272727,7,0
wikimedia_puppet,disk_cache.pp,2,0.5,2,0
wikimedia_puppet,fcgid.pp,2,0.5,2,0
wikimedia_puppet,passenger.pp,16,0.3023255813953488,5,11
wikimedia_puppet,perl.pp,2,0.5,2,0
wikimedia_puppet,proxy.pp,35,0.11946902654867257,4,31
wikimedia_puppet,proxy_html.pp,2,0.5,2,0
wikimedia_puppet,proxy_http.pp,2,0.5,2,0
wikimedia_puppet,python.pp,15,0.20689655172413793,7,8
wikimedia_puppet,ssl.pp,15,0.21739130434782608,8,7
wikimedia_puppet,userdir.pp,2,0.5,2,0
wikimedia_puppet,wsgi.pp,2,0.5,2,0
wikimedia_puppet,vhost.pp,6,0.35294117647058826,6,0
wikimedia_puppet,redirect.pp,3,0.5,3,0
wikimedia_puppet,docs.pp,6,0.25,6,0
wikimedia_puppet,bots.pp,8,0.18181818181818182,8,0
wikimedia_puppet,logbot.pp,4,0.3333333333333333,4,0
wikimedia_puppet,solr.pp,10,0.3333333333333333,3,7
wikimedia_puppet,deployment_repo_dependencies_link.pp,1,1.0,1,0
wikimedia_puppet,url-downloader.pp,2,0.5,2,0
wikimedia_puppet,mha.pp,5,0.6666666666666666,5,0
wikimedia_puppet,apache_packages.pp,4,0.25,4,0
wikimedia_puppet,systemuser.pp,5,0.5,5,0
wikimedia_puppet,cgroup.pp,9,0.17647058823529413,9,0
wikimedia_puppet,l10nupdate.pp,19,0.15384615384615385,12,7
wikimedia_puppet,mwdeploy.pp,4,0.5,4,0
wikimedia_puppet,exec_host.pp,8,0.35,8,0
wikimedia_puppet,shadow_master.pp,10,0.3125,10,0
wikimedia_puppet,submit_host.pp,8,0.3684210526315789,8,0
wikimedia_puppet,mw-extension.pp,5,0.2,5,0
wikimedia_puppet,monitoring.pp,51,0.1291139240506329,7,44
wikimedia_puppet,backup.pp,23,0.43,3,20
wikimedia_puppet,config.pp,36,0.16363636363636364,6,30
wikimedia_puppet,ruby.pp,7,0.4666666666666667,7,0
wikimedia_puppet,account_security.pp,2,0.6666666666666666,2,0
wikimedia_puppet,monitor.pp,31,0.20930232558139536,6,25
wikimedia_puppet,mysqltuner.pp,2,0.5,2,0
wikimedia_puppet,mysql_database.pp,2,0.5,2,0
wikimedia_puppet,mysql_grant.pp,1,1.0,1,0
wikimedia_puppet,mysql_user.pp,2,0.5,2,0
wikimedia_puppet,group.pp,8,0.2727272727272727,7,1
wikimedia_puppet,user.pp,25,0.14473684210526316,7,18
wikimedia_puppet,website.pp,11,0.30303030303030304,5,6
wikimedia_puppet,configuration.pp,28,0.18009478672985782,6,22
wikimedia_puppet,instance.pp,43,0.11188811188811189,7,36
wikimedia_puppet,aggregator.pp,12,0.24,6,6
wikimedia_puppet,tmpfs.pp,2,0.8,2,0
wikimedia_puppet,proxy_common.pp,5,0.5,5,0
wikimedia_puppet,proxy_jenkins.pp,3,0.6923076923076923,3,0
wikimedia_puppet,proxy_zuul.pp,2,0.5,2,0
wikimedia_puppet,testswarm.pp,3,0.5,3,0
wikimedia_puppet,redisdb.pp,13,0.22857142857142856,6,7
wikimedia_puppet,haproxy.pp,5,0.2857142857142857,5,0
wikimedia_puppet,labsredis.pp,2,0.5,2,0
wikimedia_puppet,limn.pp,7,0.4117647058823529,7,0
wikimedia_puppet,archive.pp,3,0.5,3,0
wikimedia_puppet,supervisor.pp,3,0.6,3,0
wikimedia_puppet,request-tracker.pp,4,0.625,4,0
wikimedia_puppet,apache_site.pp,2,0.5,2,0
wikimedia_puppet,cronjob.pp,6,0.35,6,0
wikimedia_puppet,dirs.pp,15,0.45569620253164556,4,11
wikimedia_puppet,docroot.pp,4,0.25,4,0
wikimedia_puppet,index_site.pp,6,0.36363636363636365,6,0
wikimedia_puppet,languages.pp,2,0.5,2,0
wikimedia_puppet,locales.pp,2,0.6666666666666666,2,0
wikimedia_puppet,theme.pp,6,0.4,6,0
wikimedia_puppet,venus.pp,5,0.5882352941176471,5,0
wikimedia_puppet,jenkins.pp,6,0.5333333333333333,6,0
wikimedia_puppet,notebook.pp,4,0.6153846153846154,4,0
wikimedia_puppet,labslamp.pp,5,0.4,5,0
wikimedia_puppet,mediawiki_errors.pp,2,0.75,2,0
wikimedia_puppet,gitblit.pp,16,0.2391304347826087,6,10
wikimedia_puppet,ceph.pp,3,0.7894736842105263,3,0
wikimedia_puppet,bootstrap_key.pp,2,0.5,2,0
wikimedia_puppet,mds.pp,2,0.6666666666666666,2,0
wikimedia_puppet,mon.pp,2,0.5,2,0
wikimedia_puppet,osd.pp,2,0.6666666666666666,2,0
wikimedia_puppet,radosgw.pp,3,0.6666666666666666,3,0
wikimedia_puppet,analysis.pp,3,0.5,3,0
wikimedia_puppet,profile.pp,3,0.5,3,0
wikimedia_puppet,labsnfs.pp,12,0.23076923076923078,8,4
wikimedia_puppet,dev_environ.pp,21,0.23157894736842105,4,17
wikimedia_puppet,exec_environ.pp,33,0.1759656652360515,6,27
wikimedia_puppet,execnode.pp,6,0.4666666666666667,6,0
wikimedia_puppet,shadow.pp,8,0.2222222222222222,8,0
wikimedia_puppet,webproxy.pp,10,0.3076923076923077,3,7
wikimedia_puppet,infrastructure.pp,9,0.5,9,0
wikimedia_puppet,mailrelay.pp,18,0.11764705882352941,9,9
wikimedia_puppet,rt-server-apache.pp,6,0.36363636363636365,6,0
wikimedia_puppet,dsh.pp,8,0.4,8,0
wikimedia_puppet,package.pp,13,0.29411764705882354,6,7
wikimedia_puppet,slave.pp,22,0.2230769230769231,6,16
wikimedia_puppet,reactors.pp,3,0.3333333333333333,3,0
wikimedia_puppet,twemproxy.pp,3,0.7272727272727273,3,0
wikimedia_puppet,memcachesasl.pp,2,0.5,2,0
wikimedia_puppet,hadoop.pp,19,0.3836477987421384,2,17
wikimedia_puppet,zookeeper.pp,8,0.42857142857142855,5,3
wikimedia_puppet,labsproxy.pp,11,0.2413793103448276,6,5
wikimedia_puppet,htcppurger.pp,9,0.25925925925925924,6,3
wikimedia_puppet,common.pp,42,0.10209424083769633,6,36
wikimedia_puppet,vcl.pp,12,0.24390243902439024,4,8
wikimedia_puppet,extra_vcl.pp,4,0.3333333333333333,4,0
wikimedia_puppet,setup_filesystem.pp,8,0.1875,8,0
wikimedia_puppet,rt.pp,9,0.35,9,0
wikimedia_puppet,simple-mail-sender.pp,2,0.5,2,0
wikimedia_puppet,spamassassin.pp,2,0.5,2,0
wikimedia_puppet,hive.pp,6,0.6,2,4
wikimedia_puppet,pig.pp,2,0.75,2,0
wikimedia_puppet,sqoop.pp,2,0.75,2,0
wikimedia_puppet,labsbeta.pp,6,0.2222222222222222,6,0
wikimedia_puppet,key.pp,5,0.36363636363636365,5,0
wikimedia_puppet,redis.pp,21,0.1941747572815534,5,16
wikimedia_puppet,ishmael.pp,11,0.23529411764705882,11,0
wikimedia_puppet,grain.pp,6,0.36363636363636365,6,0
wikimedia_puppet,target.pp,24,0.09523809523809523,5,19
wikimedia_puppet,data.pp,10,0.25,10,0
wikimedia_puppet,maxmind.pp,6,0.4444444444444444,6,0
wikimedia_puppet,tyrant.pp,3,0.6,3,0
wikimedia_puppet,eventlogging.pp,24,0.3368421052631579,4,20
wikimedia_puppet,decommission.pp,14,0.22580645161290322,10,4
wikimedia_puppet,consumer.pp,6,0.3076923076923077,6,0
wikimedia_puppet,forwarder.pp,5,0.3,5,0
wikimedia_puppet,multiplexer.pp,6,0.2857142857142857,6,0
wikimedia_puppet,processor.pp,10,0.3076923076923077,5,5
wikimedia_puppet,oozie.pp,4,0.7142857142857143,4,0
wikimedia_puppet,high-http-performance.pp,1,1.0,1,0
wikimedia_puppet,ipython_notebook.pp,3,0.5,3,0
wikimedia_puppet,plugin.pp,13,0.15789473684210525,13,0
wikimedia_puppet,advanced-routing.pp,1,1.0,1,0
wikimedia_puppet,advanced-routing-ipv6.pp,1,1.0,1,0
wikimedia_puppet,high-bandwidth-rsync.pp,2,0.5,2,0
wikimedia_puppet,ipv6-disable-ra.pp,1,1.0,1,0
wikimedia_puppet,kraken.pp,3,0.55,3,0
wikimedia_puppet,elasticsearch.pp,32,0.32298136645962733,3,29
wikimedia_puppet,hue.pp,9,0.3142857142857143,5,4
wikimedia_puppet,localssl.pp,15,0.28,5,10
wikimedia_puppet,ci.pp,22,0.30612244897959184,6,16
wikimedia_puppet,publish-console.pp,4,0.25,4,0
wikimedia_puppet,add_ip6_mapped.pp,9,0.5555555555555556,9,0
wikimedia_puppet,aggregate.pp,6,0.2857142857142857,6,0
wikimedia_puppet,manual.pp,7,0.25,7,0
wikimedia_puppet,offload.pp,7,0.25,7,0
wikimedia_puppet,tagged.pp,6,0.6,6,0
wikimedia_puppet,tun6to4.pp,5,0.2,5,0
wikimedia_puppet,job.pp,9,0.5,5,4
wikimedia_puppet,mysql-bpipe.pp,4,0.5,4,0
wikimedia_puppet,console.pp,2,0.75,2,0
wikimedia_puppet,director.pp,12,0.3076923076923077,6,6
wikimedia_puppet,catalog.pp,1,1.0,1,0
wikimedia_puppet,fileset.pp,1,1.0,1,0
wikimedia_puppet,jobdefaults.pp,1,1.0,1,0
wikimedia_puppet,pool.pp,3,0.5454545454545454,3,0
wikimedia_puppet,schedule.pp,4,0.5,4,0
wikimedia_puppet,storage.pp,10,0.34146341463414637,5,5
wikimedia_puppet,device.pp,2,0.6666666666666666,2,0
wikimedia_puppet,ip.pp,3,0.75,3,0
wikimedia_puppet,up_command.pp,3,0.3333333333333333,3,0
wikimedia_puppet,otrs.pp,19,0.5132743362831859,4,15
wikimedia_puppet,rule.pp,6,0.26666666666666666,6,0
wikimedia_puppet,check.pp,16,0.17777777777777778,6,10
wikimedia_puppet,monitor_service.pp,8,0.25,8,0
wikimedia_puppet,purge_slow_digest.pp,4,0.25,4,0
wikimedia_puppet,vhtcpd.pp,6,0.25,6,0
wikimedia_puppet,authdns.pp,6,0.5,3,3
wikimedia_puppet,account.pp,7,0.4166666666666667,7,0
wikimedia_puppet,scripts.pp,19,0.1839080459770115,8,11
wikimedia_puppet,environment.pp,8,0.42105263157894735,8,0
wikimedia_puppet,host.pp,24,0.3212121212121212,4,20
wikimedia_puppet,motd.pp,2,0.5,2,0
wikimedia_puppet,platform.pp,4,0.375,4,0
wikimedia_puppet,resolving.pp,8,0.2857142857142857,8,0
wikimedia_puppet,standard-packages.pp,16,0.2926829268292683,6,10
wikimedia_puppet,sysctl.pp,10,0.15384615384615385,10,0
wikimedia_puppet,vimconfig.pp,3,0.6,3,0
wikimedia_puppet,errors.pp,8,0.35714285714285715,8,0
wikimedia_puppet,conffile.pp,7,0.2727272727272727,7,0
wikimedia_puppet,parameters.pp,5,0.3333333333333333,5,0
wikimedia_puppet,lint.pp,3,0.5,3,0
wikimedia_puppet,kafka.pp,16,0.3761467889908257,2,14
wikimedia_puppet,git-daemon.pp,1,1.0,1,0
wikimedia_puppet,netmapper_update.pp,4,0.5555555555555556,4,0
wikimedia_puppet,labsvagrant.pp,4,0.375,4,0
wikimedia_puppet,labsbastion.pp,8,0.3,8,0
wikimedia_puppet,clone.pp,12,0.28,4,8
wikimedia_puppet,userconfig.pp,2,0.5,2,0
wikimedia_puppet,localvhost.pp,7,0.2857142857142857,7,0
wikimedia_puppet,browsertests.pp,10,0.35135135135135137,7,3
wikimedia_puppet,requisites.pp,4,0.3333333333333333,4,0
wikimedia_puppet,slave-scripts.pp,10,0.2857142857142857,10,0
wikimedia_puppet,labsvmbuilder.pp,2,0.6666666666666666,2,0
wikimedia_puppet,statsd.pp,16,0.20408163265306123,6,10
wikimedia_puppet,webnode.pp,7,0.6666666666666666,7,0
wikimedia_puppet,exec_submit_host.pp,2,0.8,2,0
wikimedia_puppet,hostkey.pp,2,0.75,2,0
wikimedia_puppet,hostkeys-collect.pp,4,0.5714285714285714,4,0
wikimedia_puppet,default_charset_binary.pp,3,0.3333333333333333,3,0
wikimedia_puppet,percona.pp,7,0.14285714285714285,7,0
wikimedia_puppet,files.pp,7,0.23076923076923078,7,0
wikimedia_puppet,apparmorservice.pp,2,0.5,2,0
wikimedia_puppet,gluster.pp,5,0.2857142857142857,5,0
wikimedia_puppet,primary.pp,18,0.3333333333333333,4,14
wikimedia_puppet,wikimedia.pp,11,0.38095238095238093,3,8
wikimedia_puppet,app.pp,12,0.3,7,5
wikimedia_puppet,web.pp,46,0.15456238361266295,5,41
wikimedia_puppet,gitpuppet.pp,6,0.5454545454545454,6,0
wikimedia_puppet,cron-rsync-dumps.pp,4,0.4,4,0
wikimedia_puppet,kiwix.pp,6,0.4090909090909091,3,3
wikimedia_puppet,api.pp,14,0.23636363636363636,7,7
wikimedia_puppet,role.pp,8,0.2222222222222222,8,0
wikimedia_puppet,set.pp,5,0.5,5,0
wikimedia_puppet,higher_min_free_kbytes.pp,3,0.5,3,0
wikimedia_puppet,international.pp,2,0.6666666666666666,2,0
wikimedia_puppet,upstart_job.pp,6,0.2857142857142857,6,0
wikimedia_puppet,wikidev-umask.pp,2,0.6666666666666666,2,0
wikimedia_puppet,gitclone.pp,17,0.2833333333333333,5,12
wikimedia_puppet,lite.pp,2,0.8,2,0
wikimedia_puppet,bin.pp,1,1.0,1,0
wikimedia_puppet,android-sdk.pp,1,1.0,1,0
wikimedia_puppet,ocg.pp,23,0.1935483870967742,4,19
wikimedia_puppet,ircd.pp,2,0.75,2,0
wikimedia_puppet,mediawiki-irc-relay.pp,2,0.75,2,0
wikimedia_puppet,gdash.pp,6,0.75,3,3
wikimedia_puppet,mwprof.pp,3,0.5,3,0
wikimedia_puppet,logstash.pp,25,0.11224489795918367,12,13
wikimedia_puppet,logmail.pp,10,0.1875,10,0
wikimedia_puppet,reporter.pp,12,0.16666666666666666,12,0
wikimedia_puppet,wikimania_scholarships.pp,14,0.15789473684210525,14,0
wikimedia_puppet,nginx.pp,8,0.25,8,0
wikimedia_puppet,uwsgi.pp,15,0.3023255813953488,4,11
wikimedia_puppet,apt-repository.pp,4,0.5,4,0
wikimedia_puppet,caching-proxy.pp,2,0.7777777777777778,2,0
wikimedia_puppet,dhcp-server.pp,4,0.6153846153846154,4,0
wikimedia_puppet,preseed-server.pp,2,0.8333333333333334,2,0
wikimedia_puppet,tftp-server.pp,3,0.45454545454545453,3,0
wikimedia_puppet,web-server.pp,2,0.8571428571428571,2,0
wikimedia_puppet,ubuntu-mirror.pp,1,1.0,1,0
wikimedia_puppet,balancer.pp,23,0.1827956989247312,5,18
wikimedia_puppet,runcommand.pp,7,0.25,7,0
wikimedia_puppet,realserver.pp,4,0.5714285714285714,4,0
wikimedia_puppet,echoirc.pp,4,0.5,4,0
wikimedia_puppet,asset_check.pp,5,0.375,5,0
wikimedia_puppet,navtiming.pp,6,0.36363636363636365,6,0
wikimedia_puppet,librenms.pp,15,0.2631578947368421,7,8
wikimedia_puppet,devices.pp,2,0.5,2,0
wikimedia_puppet,makeconfig.pp,3,0.3333333333333333,3,0
wikimedia_puppet,kibana.pp,13,0.2,9,4
wikimedia_puppet,txstatsd.pp,4,0.4,4,0
wikimedia_puppet,webperf.pp,9,0.29411764705882354,5,4
wikimedia_puppet,all.pp,9,0.16666666666666666,9,0
wikimedia_puppet,auth_file.pp,2,0.5,2,0
wikimedia_puppet,controller.pp,8,0.20408163265306123,7,1
wikimedia_puppet,compute.pp,22,0.2,7,15
wikimedia_puppet,horizon.pp,8,0.24,7,1
wikimedia_puppet,neutron.pp,8,0.44,4,4
wikimedia_puppet,provision.pp,2,0.5,2,0
wikimedia_puppet,epel.pp,2,0.5,2,0
wikimedia_puppet,rdo.pp,2,0.5,2,0
wikimedia_puppet,uca.pp,2,0.5,2,0
wikimedia_puppet,yum_refresh.pp,2,0.5,2,0
wikimedia_puppet,device_endpoint.pp,2,0.5,2,0
wikimedia_puppet,storage-node.pp,2,0.5,2,0
wikimedia_puppet,test_file.pp,2,0.5,2,0
wikimedia_puppet,cloudcontroller.pp,2,0.5,2,0
wikimedia_puppet,testfile.pp,2,0.5,2,0
wikimedia_puppet,wikimetrics.pp,14,0.32558139534883723,3,11
wikimedia_puppet,performance.pp,10,0.26666666666666666,6,4
wikimedia_puppet,ve.pp,8,0.4230769230769231,5,3
wikimedia_puppet,subversion.pp,7,0.3333333333333333,7,0
wikimedia_puppet,conversion.pp,2,0.5,2,0
wikimedia_puppet,viewvc.pp,2,0.5,2,0
wikimedia_puppet,autoupdater.pp,9,0.2857142857142857,4,5
wikimedia_puppet,fatalmonitor.pp,2,0.5,2,0
wikimedia_puppet,natdestrewrite.pp,3,0.3333333333333333,3,0
wikimedia_puppet,natfix.pp,6,0.2857142857142857,6,0
wikimedia_puppet,syncsiteresources.pp,3,0.3333333333333333,3,0
wikimedia_puppet,releases.pp,14,0.44,4,10
wikimedia_puppet,tendril.pp,16,0.19642857142857142,8,8
wikimedia_puppet,labstools.pp,10,0.4727272727272727,3,7
wikimedia_puppet,postgis.pp,6,0.46153846153846156,6,0
wikimedia_puppet,spatialdb.pp,5,0.4166666666666667,5,0
wikimedia_puppet,gridnode.pp,2,0.8888888888888888,2,0
wikimedia_puppet,hot_threads.pp,4,0.25,4,0
wikimedia_puppet,osm.pp,7,0.8333333333333334,1,6
wikimedia_puppet,labstest.pp,2,0.6,2,0
wikimedia_puppet,volume.pp,13,0.26666666666666666,6,7
wikimedia_puppet,kafkatee.pp,10,0.3870967741935484,5,5
wikimedia_puppet,access_new_install.pp,6,0.3,6,0
wikimedia_puppet,updates.pp,3,0.5555555555555556,3,0
wikimedia_puppet,maven_settings.pp,1,1.0,1,0
wikimedia_puppet,maven_webproxy.pp,2,0.6666666666666666,2,0
wikimedia_puppet,labsdb.pp,7,0.4166666666666667,7,0
wikimedia_puppet,hhvm.pp,14,0.3263157894736842,4,10
wikimedia_puppet,dataset.pp,11,0.3333333333333333,7,4
wikimedia_puppet,peers.pp,5,0.4230769230769231,3,2
wikimedia_puppet,pagecounts.pp,3,0.6,3,0
wikimedia_puppet,public.pp,4,0.6,4,0
wikimedia_puppet,searchlogs.pp,1,1.0,1,0
wikimedia_puppet,pagecountsraw.pp,6,0.3333333333333333,6,0
wikimedia_puppet,phpfiles.pp,2,0.5,2,0
wikimedia_puppet,apachesite.pp,4,0.4,4,0
wikimedia_puppet,dumps.pp,7,0.43333333333333335,5,2
wikimedia_puppet,configs.pp,6,0.47058823529411764,2,4
wikimedia_puppet,dblists.pp,3,0.47619047619047616,2,1
wikimedia_puppet,templates.pp,2,0.75,2,0
wikimedia_puppet,wikiconf.pp,2,0.8,2,0
wikimedia_puppet,pagetitles.pp,4,0.5666666666666667,2,2
wikimedia_puppet,addschanges.pp,3,0.7272727272727273,3,0
wikimedia_puppet,spatial.pp,2,0.5,2,0
wikimedia_puppet,dumplists.pp,5,0.6,5,0
wikimedia_puppet,mediadirlists.pp,3,0.5,3,0
wikimedia_puppet,labsmnt.pp,4,0.25,4,0
wikimedia_puppet,populatedb.pp,1,1.0,1,0
wikimedia_puppet,usergrants.pp,1,1.0,1,0
wikimedia_puppet,centralauthdump.pp,4,0.5454545454545454,4,0
wikimedia_puppet,submit.pp,9,0.3076923076923077,4,5
wikimedia_puppet,hba.pp,7,0.25,7,0
wikimedia_puppet,mediaperprojectlists.pp,4,0.5294117647058824,4,0
wikimedia_puppet,archiva.pp,10,0.2,7,3
wikimedia_puppet,gitfat.pp,6,0.16666666666666666,6,0
wikimedia_puppet,labssrv.pp,2,0.5,2,0
wikimedia_puppet,monitor_disk.pp,5,0.2,5,0
wikimedia_puppet,monitor_process.pp,3,0.3333333333333333,3,0
wikimedia_puppet,packages_wmf.pp,4,0.5833333333333334,4,0
wikimedia_puppet,pmacct.pp,9,0.3684210526315789,9,0
wikimedia_puppet,install.pp,12,0.3103448275862069,4,8
wikimedia_puppet,backports.pp,5,0.375,5,0
wikimedia_puppet,collector.pp,21,0.15625,5,16
wikimedia_puppet,planet_import.pp,3,0.6666666666666666,3,0
wikimedia_puppet,shapefile_import.pp,2,0.5,2,0
wikimedia_puppet,labsbiglogs.pp,3,0.3333333333333333,3,0
wikimedia_puppet,mwdeploy_sudo.pp,3,0.5,3,0
wikimedia_puppet,rsync_slave.pp,3,0.5,3,0
wikimedia_puppet,deprecate.pp,2,0.6666666666666666,2,0
wikimedia_puppet,tcpircbot.pp,12,0.3,6,6
wikimedia_puppet,rps.pp,6,0.42857142857142855,4,2
wikimedia_puppet,dependencies.pp,7,0.4117647058823529,7,0
wikimedia_puppet,apachesync.pp,4,0.4,4,0
wikimedia_puppet,zero_update.pp,9,0.4117647058823529,9,0
wikimedia_puppet,monitor_replication.pp,5,0.3333333333333333,5,0
wikimedia_puppet,generic.pp,6,0.5,6,0
wikimedia_puppet,diamond.pp,14,0.20512820512820512,9,5
wikimedia_puppet,rcstream.pp,13,0.23684210526315788,6,7
wikimedia_puppet,bundle.pp,2,0.6666666666666666,2,0
wikimedia_puppet,differ.pp,2,0.8,2,0
wikimedia_puppet,groupmembers.pp,5,0.5,5,0
wikimedia_puppet,hashgroup.pp,4,0.25,4,0
wikimedia_puppet,hashuser.pp,4,0.4,4,0
wikimedia_puppet,puppet_compiler.pp,6,0.6842105263157895,6,0
wikimedia_puppet,mw-rc-irc.pp,4,0.5,4,0
wikimedia_puppet,irc-echo.pp,4,0.4,4,0
wikimedia_puppet,ircserver.pp,11,0.391304347826087,3,8
wikimedia_puppet,naggen2.pp,2,0.8333333333333334,2,0
wikimedia_puppet,rpstools.pp,3,0.5,3,0
wikimedia_puppet,disable.pp,3,0.5,3,0
wikimedia_puppet,txqueuelen.pp,5,0.3333333333333333,5,0
wikimedia_puppet,refinery.pp,10,0.39436619718309857,4,6
wikimedia_puppet,min_free_kbytes.pp,2,0.75,2,0
wikimedia_puppet,ring.pp,6,0.5,6,0
wikimedia_puppet,setting.pp,2,0.5,2,0
wikimedia_puppet,mongo.pp,1,1.0,1,0
wikimedia_puppet,mwlogdir.pp,2,0.5,2,0
wikimedia_puppet,merger.pp,9,0.3488372093023256,6,3
wikimedia_puppet,jobqueue.pp,5,0.4,5,0
wikimedia_puppet,multimedia.pp,9,0.2926829268292683,5,4
wikimedia_puppet,gelf.pp,3,0.5,3,0
wikimedia_puppet,puppetproxy.pp,2,0.5,2,0
wikimedia_puppet,git_merge.pp,3,0.625,3,0
wikimedia_puppet,dkim.pp,2,0.6666666666666666,2,0
wikimedia_puppet,has_interface_with.pp,2,0.6666666666666666,2,0
wikimedia_puppet,has_ip_address.pp,2,0.6666666666666666,2,0
wikimedia_puppet,has_ip_network.pp,2,0.6666666666666666,2,0
wikimedia_puppet,mod_conf.pp,4,0.42857142857142855,4,0
wikimedia_puppet,labsswiftpartition.pp,3,0.3333333333333333,3,0
wikimedia_puppet,cxserver.pp,8,0.3870967741935484,4,4
wikimedia_puppet,def.pp,3,0.5,3,0
wikimedia_puppet,phabricator.pp,23,0.3067484662576687,5,18
wikimedia_puppet,minimalpuppetagent.pp,8,0.18181818181818182,8,0
wikimedia_puppet,configfile.pp,1,1.0,1,0
wikimedia_puppet,decom.pp,2,0.5,2,0
wikimedia_puppet,sites.pp,9,0.4666666666666667,9,0
wikimedia_puppet,hardlink.pp,3,0.3333333333333333,3,0
wikimedia_puppet,wikidatajsondumps.pp,1,1.0,1,0
wikimedia_puppet,wikidatajsondump.pp,2,0.8,2,0
wikimedia_puppet,tools.pp,23,0.30303030303030304,5,18
wikimedia_puppet,reprepro.pp,8,0.375,3,5
wikimedia_puppet,distribution.pp,2,0.6666666666666666,2,0
wikimedia_puppet,tor.pp,3,0.5,3,0
wikimedia_puppet,mpm.pp,7,0.3333333333333333,7,0
wikimedia_puppet,qunit_localhost.pp,4,0.4,4,0
wikimedia_puppet,extdist.pp,5,0.3333333333333333,5,0
wikimedia_puppet,modules.pp,4,0.8235294117647058,4,0
wikimedia_puppet,labsquarry.pp,3,0.5,3,0
wikimedia_puppet,celeryrunner.pp,9,0.25,9,0
wikimedia_puppet,mathoid.pp,7,0.46153846153846156,3,4
wikimedia_puppet,envvars.pp,2,0.5,2,0
wikimedia_puppet,status.pp,3,0.3333333333333333,3,0
wikimedia_puppet,transparency.pp,9,0.4375,9,0
wikimedia_puppet,admin.pp,4,0.5714285714285714,4,0
wikimedia_puppet,planet_sync.pp,4,0.5217391304347826,4,0
wikimedia_puppet,env.pp,3,0.3333333333333333,3,0
wikimedia_puppet,select.pp,1,1.0,1,0
wikimedia_puppet,proxy_gerrit.pp,2,0.5,2,0
wikimedia_puppet,labmon.pp,4,0.4444444444444444,4,0
wikimedia_puppet,trebuchet.pp,7,0.3333333333333333,7,0
wikimedia_puppet,php5.pp,7,0.35294117647058826,7,0
wikimedia_puppet,fonts.pp,12,0.21052631578947367,8,4
wikimedia_puppet,beta_sites.pp,9,0.2727272727272727,5,4
wikimedia_puppet,peopleweb.pp,5,0.42105263157894735,5,0
wikimedia_puppet,servermon.pp,6,0.36363636363636365,6,0
wikimedia_puppet,migration.pp,8,0.5135135135135135,4,4
wikimedia_puppet,pybal_config.pp,3,0.5714285714285714,3,0
wikimedia_puppet,scap.pp,17,0.13043478260869565,5,12
wikimedia_puppet,hiera.pp,4,0.25,4,0
wikimedia_puppet,interface-tweaks.pp,3,0.6,3,0
wikimedia_puppet,labsshinken.pp,2,0.6666666666666666,2,0
wikimedia_puppet,user_macros.pp,3,0.3333333333333333,3,0
wikimedia_puppet,check_command.pp,5,0.5,5,0
wikimedia_puppet,commands.pp,15,0.2987012987012987,5,10
wikimedia_puppet,grafana.pp,15,0.20512820512820512,5,10
wikimedia_puppet,url_downloader.pp,10,0.5641025641025641,5,5
wikimedia_puppet,daemon.pp,9,0.35,9,0
wikimedia_puppet,timeperiods.pp,2,0.6666666666666666,2,0
wikimedia_puppet,notification_commands.pp,4,0.5,4,0
wikimedia_puppet,logrotate.pp,4,0.4,4,0
wikimedia_puppet,checkpaging.pp,6,0.2222222222222222,6,0
wikimedia_puppet,contacts.pp,10,0.35294117647058826,10,0
wikimedia_puppet,naggen.pp,7,0.25,7,0
wikimedia_puppet,misc.pp,31,0.2554112554112554,4,27
wikimedia_puppet,plugins.pp,12,0.2894736842105263,9,3
wikimedia_puppet,global.pp,9,0.45454545454545453,3,6
wikimedia_puppet,init_device.pp,4,0.7,4,0
wikimedia_puppet,label_filesystem.pp,1,1.0,1,0
wikimedia_puppet,mount_filesystem.pp,1,1.0,1,0
wikimedia_puppet,accounts.pp,1,1.0,1,0
wikimedia_puppet,dispersion.pp,1,1.0,1,0
wikimedia_puppet,stats_account.pp,1,1.0,1,0
wikimedia_puppet,monitor_swift_daemon.pp,3,0.6666666666666666,3,0
wikimedia_puppet,openldap.pp,8,0.36363636363636365,4,4
wikimedia_puppet,libext.pp,5,0.25,5,0
wikimedia_puppet,pagecounts_all_sites.pp,2,0.5,2,0
wikimedia_puppet,citoid.pp,6,0.47058823529411764,6,0
wikimedia_puppet,container_sync.pp,2,0.8333333333333334,2,0
wikimedia_puppet,extend.pp,4,0.25,4,0
wikimedia_puppet,resource.pp,6,0.47368421052631576,6,0
wikimedia_puppet,resourcedir.pp,6,0.5714285714285714,6,0
wikimedia_puppet,hostgroup.pp,4,0.8,4,0
wikimedia_puppet,queue.pp,7,0.46153846153846156,7,0
wikimedia_puppet,continuous.pp,2,0.6666666666666666,2,0
wikimedia_puppet,task.pp,2,0.6666666666666666,2,0
wikimedia_puppet,iegreview.pp,9,0.1111111111111111,9,0
wikimedia_puppet,apertium.pp,8,0.41379310344827586,3,5
wikimedia_puppet,requesttracker.pp,10,0.34782608695652173,3,7
wikimedia_puppet,forms.pp,1,1.0,1,0
wikimedia_puppet,labs-archiver.pp,1,1.0,1,0
wikimedia_puppet,archiver.pp,7,0.2727272727272727,7,0
wikimedia_puppet,general.pp,13,0.23333333333333334,5,8
wikimedia_puppet,lighttpd.pp,6,0.2727272727272727,6,0
wikimedia_puppet,tomcat.pp,2,0.5,2,0
wikimedia_puppet,script.pp,6,0.16666666666666666,6,0
wikimedia_puppet,crons.pp,3,0.782608695652174,2,1
wikimedia_puppet,jetty.pp,16,0.5803571428571429,3,13
wikimedia_puppet,replicationdest.pp,5,0.375,5,0
wikimedia_puppet,shinkengen.pp,10,0.29411764705882354,10,0
wikimedia_puppet,hostgroups.pp,3,0.75,3,0
wikimedia_puppet,join.pp,3,0.3333333333333333,3,0
wikimedia_puppet,queues.pp,3,0.7777777777777778,3,0
wikimedia_puppet,dedicated.pp,6,0.25,6,0
wikimedia_puppet,adminscripts.pp,5,0.42857142857142855,4,1
wikimedia_puppet,api-service.pp,1,1.0,1,0
wikimedia_puppet,compute-service.pp,1,1.0,1,0
wikimedia_puppet,conductor-service.pp,1,1.0,1,0
wikimedia_puppet,database-server.pp,5,0.6,5,0
wikimedia_puppet,glance-service.pp,1,1.0,1,0
wikimedia_puppet,keystone-service.pp,1,1.0,1,0
wikimedia_puppet,network-service.pp,1,1.0,1,0
wikimedia_puppet,neutron-compute.pp,1,1.0,1,0
wikimedia_puppet,neutron-controller.pp,1,1.0,1,0
wikimedia_puppet,neutron-nethost.pp,1,1.0,1,0
wikimedia_puppet,openstack-manager.pp,10,0.38461538461538464,5,5
wikimedia_puppet,project-nfs-storage-service.pp,7,0.3,7,0
wikimedia_puppet,queue-server.pp,4,0.2857142857142857,4,0
wikimedia_puppet,scheduler-service.pp,1,1.0,1,0
wikimedia_puppet,volume-service.pp,1,1.0,1,0
wikimedia_puppet,conductor.pp,5,0.35294117647058826,5,0
wikimedia_puppet,scheduler.pp,10,0.1935483870967742,7,3
wikimedia_puppet,nethost.pp,4,0.4,4,0
wikimedia_puppet,admin_host.pp,4,0.25,4,0
wikimedia_puppet,labs_project.pp,4,0.5,4,0
wikimedia_puppet,bastionhost.pp,4,0.2857142857142857,4,0
wikimedia_puppet,browsers.pp,7,0.2727272727272727,7,0
wikimedia_puppet,static.pp,16,0.1951219512195122,4,12
wikimedia_puppet,sysctl_settings.pp,2,0.6666666666666666,2,0
wikimedia_puppet,ipmi.pp,1,1.0,1,0
wikimedia_puppet,phd.pp,6,0.4117647058823529,6,0
wikimedia_puppet,aliases.pp,3,0.4,3,0
wikimedia_puppet,mysqlset.pp,4,0.4,4,0
wikimedia_puppet,weeklyschedule.pp,2,0.5,2,0
wikimedia_puppet,postgres.pp,3,0.7,3,0
wikimedia_puppet,hosts.pp,2,0.5,2,0
wikimedia_puppet,extension.pp,9,0.1875,9,0
wikimedia_puppet,redirector.pp,8,0.3333333333333333,8,0
wikimedia_puppet,graphite_threshold.pp,8,0.25,8,0
wikimedia_puppet,graphite_anomaly.pp,7,0.2857142857142857,7,0
wikimedia_puppet,gsbmonitoring.pp,4,0.4,4,0
wikimedia_puppet,debug.pp,5,0.42857142857142855,5,0
wikimedia_puppet,file.pp,3,0.7692307692307693,3,0
wikimedia_puppet,shinken.pp,6,0.38461538461538464,6,0
wikimedia_puppet,decommission_host.pp,1,1.0,1,0
wikimedia_puppet,defaults.pp,6,0.3333333333333333,6,0
wikimedia_puppet,gmetad.pp,5,0.3333333333333333,5,0
wikimedia_puppet,rrdcached.pp,4,0.4,4,0
wikimedia_puppet,services.pp,19,0.2558139534883721,5,14
wikimedia_puppet,mysqlpath.pp,2,0.5,2,0
wikimedia_puppet,mysqluser.pp,3,0.3333333333333333,3,0
wikimedia_puppet,ircbot.pp,17,0.15625,9,8
wikimedia_puppet,private_key.pp,3,0.5,3,0
wikimedia_puppet,restbase.pp,11,0.4864864864864865,4,7
wikimedia_puppet,phaste.pp,2,0.5,2,0
wikimedia_puppet,cassandra.pp,13,0.36363636363636365,4,9
wikimedia_puppet,discovery.pp,6,0.28,5,1
wikimedia_puppet,ddxfile.pp,1,1.0,1,0
wikimedia_puppet,cdn.pp,10,0.21739130434782608,5,5
wikimedia_puppet,xmlconfig.pp,2,0.6666666666666666,2,0
wikimedia_puppet,ircyall.pp,1,1.0,1,0
wikimedia_puppet,housekeeping.pp,1,1.0,1,0
wikimedia_puppet,scap_proxy.pp,1,1.0,1,0
wikimedia_puppet,gitsync.pp,5,0.46153846153846156,5,0
wikimedia_puppet,monitor_pdu_3phase.pp,2,0.8,2,0
wikimedia_puppet,monitor_pdu_service.pp,4,0.42857142857142855,4,0
wikimedia_puppet,view.pp,3,0.3333333333333333,3,0
wikimedia_puppet,tcp.pp,3,0.3333333333333333,3,0
wikimedia_puppet,statsv.pp,15,0.22727272727272727,7,8
wikimedia_puppet,labswdq-mm.pp,2,0.5,2,0
wikimedia_puppet,lb.pp,5,0.3333333333333333,5,0
wikimedia_puppet,mpm_config.pp,3,0.7142857142857143,3,0
wikimedia_puppet,mahout.pp,2,0.5,2,0
wikimedia_puppet,decommission_monitor_host.pp,2,0.6666666666666666,2,0
wikimedia_puppet,xenon.pp,8,0.3181818181818182,5,3
wikimedia_puppet,partition.pp,5,0.5833333333333334,5,0
wikimedia_puppet,abacist.pp,4,0.5714285714285714,4,0
wikimedia_puppet,ubuntu.pp,2,0.8,2,0
wikimedia_puppet,debian.pp,2,0.9166666666666666,2,0
wikimedia_puppet,serve.pp,4,0.42857142857142855,4,0
wikimedia_puppet,extended.pp,2,0.5,2,0
wikimedia_puppet,annualreport.pp,5,0.6153846153846154,5,0
wikimedia_puppet,listserve.pp,4,0.625,4,0
wikimedia_puppet,webui.pp,8,0.38461538461538464,8,0
wikimedia_puppet,dataset_mount.pp,4,0.5,4,0
wikimedia_puppet,password.pp,1,1.0,1,0
wikimedia_puppet,webrequest.pp,18,0.2,5,13
wikimedia_puppet,rsync_job.pp,5,0.5,5,0
wikimedia_puppet,rsyncd.pp,9,0.2222222222222222,9,0
wikimedia_puppet,datasets.pp,4,0.4444444444444444,4,0
wikimedia_puppet,metrics.pp,15,0.2916666666666667,5,10
wikimedia_puppet,reportcard.pp,2,0.5,2,0
wikimedia_puppet,stats.pp,11,0.25,6,5
wikimedia_puppet,generate.pp,2,0.5,2,0
wikimedia_puppet,cron_blog_pageviews.pp,2,0.5,2,0
wikimedia_puppet,sca.pp,7,0.375,7,0
wikimedia_puppet,devportal.pp,2,0.6666666666666666,2,0
wikimedia_puppet,mysql_conf.pp,3,0.6,3,0
wikimedia_puppet,private_data.pp,4,0.5,4,0
wikimedia_puppet,grub.pp,6,0.46153846153846156,6,0
wikimedia_puppet,screenconfig.pp,1,1.0,1,0
wikimedia_puppet,remote-syslog.pp,2,0.5,2,0
wikimedia_puppet,syslogs.pp,3,0.5,3,0
wikimedia_puppet,html.pp,5,0.45,5,0
wikimedia_puppet,service_unit.pp,11,0.32,4,7
wikimedia_puppet,spark.pp,3,0.42857142857142855,3,0
wikimedia_puppet,php_enmod.pp,4,0.4,4,0
wikimedia_puppet,zotero.pp,6,0.4444444444444444,6,0
wikimedia_puppet,mediacounts.pp,1,1.0,1,0
wikimedia_puppet,statsdlb.pp,6,0.4166666666666667,6,0
wikimedia_puppet,ipsec.pp,12,0.23684210526315788,10,2
wikimedia_puppet,toolwatcher.pp,2,0.8,2,0
wikimedia_puppet,helper_scripts.pp,1,1.0,1,0
wikimedia_puppet,instance-upstarts.pp,1,1.0,1,0
wikimedia_puppet,labslvm.pp,3,0.3333333333333333,3,0
wikimedia_puppet,userkey.pp,5,0.375,5,0
wikimedia_puppet,deployaccess.pp,11,0.16666666666666666,11,0
wikimedia_puppet,replica_management_service.pp,2,0.6666666666666666,2,0
wikimedia_puppet,autosigner.pp,4,0.25,4,0
wikimedia_puppet,designate.pp,8,0.3611111111111111,5,3
wikimedia_puppet,labsdns.pp,8,0.43333333333333335,6,2
wikimedia_puppet,ca.pp,3,0.5,3,0
wikimedia_puppet,certificate.pp,8,0.36363636363636365,5,3
wikimedia_puppet,chainedcert.pp,5,0.5714285714285714,5,0
wikimedia_puppet,ocsp_updater.pp,5,0.4166666666666667,5,0
wikimedia_puppet,jsbench.pp,5,0.6363636363636364,5,0
wikimedia_puppet,ganeti.pp,7,0.6857142857142857,2,5
wikimedia_puppet,kvm.pp,3,0.5,3,0
wikimedia_puppet,conntrack.pp,2,0.6666666666666666,2,0
wikimedia_puppet,zim.pp,7,0.2857142857142857,7,0
wikimedia_puppet,wikidatadumps.pp,6,0.3333333333333333,6,0
wikimedia_puppet,rrd_navtiming.pp,2,0.6666666666666666,2,0
wikimedia_puppet,statsite.pp,4,0.5,4,0
wikimedia_puppet,environments.pp,2,0.9090909090909091,2,0
wikimedia_puppet,hooks.pp,6,0.391304347826087,4,2
wikimedia_puppet,pbuilder_base.pp,1,1.0,1,0
wikimedia_puppet,pbuilder_hook.pp,5,0.45454545454545453,5,0
wikimedia_puppet,brrd.pp,1,1.0,1,0
wikimedia_puppet,2layer.pp,5,0.6071428571428571,4,1
wikimedia_puppet,node.pp,19,0.3522727272727273,4,15
wikimedia_puppet,1layer.pp,2,0.6666666666666666,2,0
wikimedia_puppet,bits.pp,5,0.5294117647058824,5,0
wikimedia_puppet,eventlistener.pp,4,0.42857142857142855,4,0
wikimedia_puppet,local.pp,2,0.8,2,0
wikimedia_puppet,sni.pp,2,0.75,2,0
wikimedia_puppet,text.pp,16,0.32298136645962733,5,11
wikimedia_puppet,upload.pp,14,0.37423312883435583,3,11
wikimedia_puppet,certmanager.pp,5,0.375,5,0
wikimedia_puppet,perf.pp,5,0.8181818181818182,1,4
wikimedia_puppet,coal.pp,5,0.375,5,0
wikimedia_puppet,impala.pp,4,0.5,4,0
wikimedia_puppet,carbon_c_relay.pp,4,0.5,4,0
wikimedia_puppet,graphoid.pp,5,0.5555555555555556,5,0
wikimedia_puppet,extendedexim.pp,3,0.5,3,0
wikimedia_puppet,localcrontab.pp,4,0.4,4,0
wikimedia_puppet,policysite.pp,2,0.6666666666666666,2,0
wikimedia_puppet,swap.pp,6,0.4666666666666667,6,0
wikimedia_puppet,checker.pp,10,0.2682926829268293,4,6
wikimedia_puppet,ripeatlas.pp,6,0.4166666666666667,6,0
wikimedia_puppet,labsmesos.pp,2,0.8,2,0
wikimedia_puppet,ceilometer.pp,2,0.6666666666666666,2,0
wikimedia_puppet,remote_syslog.pp,4,0.6,4,0
wikimedia_puppet,monitor_systemd_unit.pp,2,0.5,2,0
wikimedia_puppet,systemd_scripts.pp,5,0.3,5,0
wikimedia_puppet,etcd.pp,6,0.5769230769230769,3,3
wikimedia_puppet,labsores.pp,3,0.5357142857142857,2,1
wikimedia_puppet,generators.pp,4,0.42857142857142855,4,0
wikimedia_puppet,collector_module.pp,2,0.6666666666666666,2,0
wikimedia_puppet,certificates.pp,7,0.45,7,0
wikimedia_puppet,custom.pp,1,1.0,1,0
wikimedia_puppet,controller_firewall.pp,5,0.46153846153846156,5,0
wikimedia_puppet,spreadcheck.pp,4,0.3333333333333333,4,0
wikimedia_puppet,varnishreqstats.pp,4,0.5,4,0
wikimedia_puppet,redisproxy.pp,2,0.5,2,0
wikimedia_puppet,dir.pp,1,1.0,1,0
wikimedia_puppet,reap.pp,2,0.5,2,0
wikimedia_puppet,vcs.pp,9,0.4,6,3
wikimedia_puppet,confd.pp,3,0.5,3,0
wikimedia_puppet,director_scripts.pp,2,0.5,2,0
wikimedia_puppet,directors.pp,5,0.3888888888888889,5,0
wikimedia_puppet,bugzilla_static.pp,1,1.0,1,0
wikimedia_puppet,fileserver.pp,7,0.4,5,2
wikimedia_puppet,relic.pp,3,0.3333333333333333,3,0
wikimedia_puppet,xcps.pp,5,0.625,5,0
wikimedia_puppet,monitor_service6_http_https.pp,1,1.0,1,0
wikimedia_puppet,monitor_service_http.pp,1,1.0,1,0
wikimedia_puppet,monitor_service_http_https.pp,2,0.75,2,0
wikimedia_puppet,jobs.pp,2,0.6666666666666666,2,0
wikimedia_puppet,projectcounts.pp,2,0.5,2,0
wikimedia_puppet,projectview.pp,4,0.42857142857142855,4,0
wikimedia_puppet,unified.pp,4,0.6538461538461539,2,2
wikimedia_puppet,tessera.pp,2,0.6666666666666666,2,0
wikimedia_puppet,installserver.pp,7,0.4827586206896552,5,2
wikimedia_puppet,tlsproxy.pp,4,0.6923076923076923,4,0
wikimedia_puppet,betassl.pp,2,0.5,2,0
wikimedia_puppet,replica_accounts.pp,1,1.0,1,0
wikimedia_puppet,replica_users.pp,3,0.3333333333333333,3,0
wikimedia_puppet,std_cert.pp,1,1.0,1,0
wikimedia_puppet,private.pp,11,0.45454545454545453,5,6
wikimedia_puppet,exports.pp,10,0.3103448275862069,5,5
wikimedia_puppet,phab_dump.pp,2,0.9,2,0
wikimedia_puppet,certcleaner.pp,3,0.5,3,0
wikimedia_puppet,rls.pp,4,0.6923076923076923,4,0
wikimedia_puppet,kernel.pp,5,0.625,5,0
wikimedia_puppet,worker.pp,17,0.20987654320987653,7,10
wikimedia_puppet,dhparam.pp,2,0.5,2,0
wikimedia_puppet,ocsp_stapler.pp,3,0.4444444444444444,3,0
wikimedia_puppet,conf_file.pp,1,1.0,1,0
wikimedia_puppet,dc_pools.pp,1,1.0,1,0
wikimedia_puppet,worker_localhost.pp,4,0.5555555555555556,4,0
wikimedia_puppet,nodepool.pp,7,0.32142857142857145,6,1
wikimedia_puppet,mwextension.pp,1,1.0,1,0
wikimedia_puppet,maps.pp,13,0.2967032967032967,3,10
wikimedia_puppet,novamigrate.pp,1,1.0,1,0
wikimedia_puppet,migrate.pp,4,0.4444444444444444,4,0
wikimedia_puppet,wikilabels.pp,2,0.5,2,0
wikimedia_puppet,db_proxy.pp,1,1.0,1,0
wikimedia_puppet,session.pp,1,1.0,1,0
wikimedia_puppet,kartotherian.pp,1,1.0,1,0
wikimedia_puppet,flower.pp,5,0.3333333333333333,5,0
wikimedia_puppet,wdqs.pp,11,0.5384615384615384,5,6
wikimedia_puppet,gui.pp,6,0.6551724137931034,4,2
wikimedia_puppet,blazegraph.pp,5,0.45454545454545453,5,0
wikimedia_puppet,updater.pp,6,0.5263157894736842,6,0
wikimedia_puppet,labsmwvagrant.pp,1,1.0,1,0
wikimedia_puppet,lxc.pp,6,0.25,6,0
wikimedia_puppet,replicate.pp,6,0.45454545454545453,6,0
wikimedia_puppet,account_services.pp,7,0.4090909090909091,3,4
wikimedia_puppet,udp.pp,4,0.3333333333333333,4,0
wikimedia_puppet,import_waterlines.pp,5,0.3333333333333333,5,0
wikimedia_puppet,cleanup_snapshots.pp,5,0.375,5,0
wikimedia_puppet,lists.pp,9,0.5098039215686274,4,5
wikimedia_puppet,monitor_systemd_unit_lastrun.pp,2,0.8,2,0
wikimedia_puppet,monitor_systemd_unit_state.pp,5,0.5,5,0
wikimedia_puppet,debdeploy.pp,3,0.8,3,0
wikimedia_puppet,stagesconf.pp,2,0.875,2,0
wikimedia_puppet,stagesconfig.pp,3,0.5416666666666666,2,1
wikimedia_puppet,docker.pp,9,0.40540540540540543,4,5
wikimedia_puppet,flannel.pp,6,0.52,5,1
wikimedia_puppet,labsk8s.pp,2,0.5,2,0
wikimedia_puppet,kubelet.pp,4,0.40625,3,1
wikimedia_puppet,receiver.pp,4,0.6363636363636364,4,0
wikimedia_puppet,apiserver.pp,3,0.37209302325581395,3,0
wikimedia_puppet,aptly.pp,5,0.45454545454545453,5,0
wikimedia_puppet,scb.pp,7,0.5,3,4
wikimedia_puppet,tilerator.pp,1,1.0,1,0
wikimedia_puppet,mobileapps.pp,3,0.625,3,0
wikimedia_puppet,setup.pp,3,0.75,3,0
wikimedia_puppet,labsvagrantlxc.pp,1,1.0,1,0
wikimedia_puppet,deployment_script.pp,1,1.0,1,0
wikimedia_puppet,precached.pp,4,0.3333333333333333,4,0
wikimedia_puppet,nutcracker.pp,6,0.2916666666666667,5,1
wikimedia_puppet,agent.pp,9,0.25,9,0
wikimedia_puppet,legal.pp,3,0.5555555555555556,3,0
wikimedia_puppet,servicestats.pp,4,0.4,4,0
wikimedia_puppet,python_dev_jessie.pp,2,0.6666666666666666,2,0
wikimedia_puppet,python_dev_precise.pp,2,0.6666666666666666,2,0
wikimedia_puppet,python_dev_trusty.pp,2,0.6666666666666666,2,0
wikimedia_puppet,python_exec_jessie.pp,5,0.7142857142857143,5,0
wikimedia_puppet,python_exec_precise.pp,4,0.7692307692307693,4,0
wikimedia_puppet,python_exec_trusty.pp,5,0.7142857142857143,5,0
wikimedia_puppet,graphite_alerts.pp,3,0.5714285714285714,3,0
wikimedia_puppet,apiserver_ssl.pp,1,1.0,1,0
wikimedia_puppet,ca_manager.pp,2,0.5,2,0
wikimedia_puppet,media.pp,6,0.47619047619047616,3,3
wikimedia_puppet,labsphragile.pp,2,0.5,2,0
wikimedia_puppet,cleanup_upload_stash.pp,1,1.0,1,0
wikimedia_puppet,echo_mail_batch.pp,2,0.5,2,0
wikimedia_puppet,pagetriage.pp,2,0.6666666666666666,2,0
wikimedia_puppet,parsercachepurging.pp,3,0.6,3,0
wikimedia_puppet,purge_abusefilter.pp,4,0.42857142857142855,4,0
wikimedia_puppet,purge_checkuser.pp,2,0.5,2,0
wikimedia_puppet,purge_securepoll.pp,3,0.3333333333333333,3,0
wikimedia_puppet,refreshlinks.pp,5,0.4444444444444444,5,0
wikimedia_puppet,tor_exit_node.pp,2,0.6666666666666666,2,0
wikimedia_puppet,translationnotifications.pp,3,0.3333333333333333,3,0
wikimedia_puppet,update_article_count.pp,2,0.5,2,0
wikimedia_puppet,update_flaggedrev_stats.pp,2,0.5,2,0
wikimedia_puppet,update_special_pages.pp,1,1.0,1,0
wikimedia_puppet,updatequerypages.pp,5,0.3333333333333333,5,0
wikimedia_puppet,updatetranslationstats.pp,1,1.0,1,0
wikimedia_puppet,sentry.pp,4,0.5,4,0
wikimedia_puppet,static_site.pp,2,0.5,2,0
wikimedia_puppet,ops.pp,19,0.38636363636363635,7,12
wikimedia_puppet,deploy.pp,7,0.3,7,0
wikimedia_puppet,kube2proxy.pp,6,0.34615384615384615,4,2
wikimedia_puppet,aqs.pp,11,0.23684210526315788,8,3
wikimedia_puppet,hook.pp,2,0.5,2,0
wikimedia_puppet,ocsp.pp,3,0.5,3,0
wikimedia_puppet,stats_container.pp,2,0.5,2,0
wikimedia_puppet,labswdq_mm.pp,1,1.0,1,0
wikimedia_puppet,mw_rc_irc.pp,8,0.5333333333333333,8,0
wikimedia_puppet,infrastructure_config.pp,4,0.3333333333333333,4,0
wikimedia_puppet,grafana2.pp,2,0.7142857142857143,2,0
wikimedia_puppet,dashboard.pp,5,0.3125,5,0
wikimedia_puppet,spare.pp,3,0.3333333333333333,3,0
wikimedia_puppet,testsystem.pp,1,1.0,1,0
wikimedia_puppet,composer.pp,4,0.375,4,0
wikimedia_puppet,ui.pp,5,0.4444444444444444,4,1
wikimedia_puppet,jobqueue_stats.pp,2,0.5,2,0
wikimedia_puppet,backend.pp,14,0.273972602739726,7,7
wikimedia_puppet,frontend.pp,14,0.2857142857142857,6,8
wikimedia_puppet,reqstats.pp,12,0.2857142857142857,7,5
wikimedia_puppet,prod_sites.pp,7,0.875,1,6
wikimedia_puppet,pageviews.pp,1,1.0,1,0
wikimedia_puppet,salt_masters.pp,4,0.2857142857142857,4,0
wikimedia_puppet,wikitech.pp,12,0.25,6,6
wikimedia_puppet,burrow.pp,9,0.2631578947368421,9,0
wikimedia_puppet,cirrussearch.pp,7,0.34615384615384615,5,2
wikimedia_puppet,corp.pp,5,0.5263157894736842,5,0
wikimedia_puppet,labsaliaser.pp,8,0.3888888888888889,8,0
wikimedia_puppet,php_engine.pp,3,0.5,3,0
wikimedia_puppet,includes.pp,2,0.6666666666666666,2,0
wikimedia_puppet,nss.pp,6,0.3333333333333333,6,0
wikimedia_puppet,pam.pp,3,0.6,3,0
wikimedia_puppet,ldap_schema.pp,2,0.5,2,0
wikimedia_puppet,legacy.pp,7,0.3076923076923077,7,0
wikimedia_puppet,registry.pp,9,0.4716981132075472,4,5
wikimedia_puppet,autorestarter.pp,2,0.5,2,0
wikimedia_puppet,simplelamp.pp,5,0.2857142857142857,5,0
wikimedia_puppet,simplelap.pp,5,0.3333333333333333,5,0
wikimedia_puppet,mysterious_sysctl.pp,1,1.0,1,0
wikimedia_puppet,project_master.pp,5,0.2,5,0
wikimedia_puppet,production.pp,23,0.27058823529411763,4,19
wikimedia_puppet,minions.pp,9,0.25,9,0
wikimedia_puppet,mattermost.pp,1,1.0,1,0
wikimedia_puppet,matterircd.pp,2,0.75,2,0
wikimedia_puppet,mnt.pp,3,0.3333333333333333,3,0
wikimedia_puppet,srv.pp,3,0.5,3,0
wikimedia_puppet,mediawiki_vagrant.pp,3,0.625,3,0
wikimedia_puppet,extras.pp,2,0.5,2,0
wikimedia_puppet,novaproxy.pp,7,0.16666666666666666,7,0
wikimedia_puppet,vmbuilder.pp,2,0.5,2,0
wikimedia_puppet,dnsrecursor.pp,16,0.18867924528301888,7,9
wikimedia_puppet,phragile.pp,1,1.0,1,0
wikimedia_puppet,wdq_mm.pp,2,0.5,2,0
wikimedia_puppet,monitoring_groups.pp,2,0.5,2,0
wikimedia_puppet,jobqueue_redis.pp,5,0.5263157894736842,5,0
wikimedia_puppet,remove_instance.pp,2,0.5,2,0
wikimedia_puppet,ores.pp,4,0.631578947368421,4,0
wikimedia_puppet,gsb.pp,1,1.0,1,0
wikimedia_puppet,arcanist.pp,3,0.6,3,0
wikimedia_puppet,globalconfig.pp,2,0.6,2,0
wikimedia_puppet,access.pp,1,1.0,1,0
wikimedia_puppet,javascript.pp,5,0.2857142857142857,5,0
wikimedia_puppet,simplestatic.pp,5,0.3333333333333333,5,0
wikimedia_puppet,slave_scripts.pp,4,0.5555555555555556,4,0
wikimedia_puppet,contactgroups.pp,2,0.5,2,0
wikimedia_puppet,instance_upstarts.pp,1,1.0,1,0
wikimedia_puppet,cluster.pp,2,0.5,2,0
wikimedia_puppet,base_repo.pp,1,1.0,1,0
wikimedia_puppet,broker.pp,12,0.532967032967033,4,8
wikimedia_puppet,ferm.pp,5,0.5384615384615384,5,0
wikimedia_puppet,source.pp,12,0.17857142857142858,8,4
wikimedia_puppet,eventbus.pp,9,0.5,2,7
wikimedia_puppet,testing.pp,7,0.4782608695652174,4,3
wikimedia_puppet,metalresolver.pp,2,0.6666666666666666,2,0
wikimedia_puppet,mysql_bpipe.pp,2,0.6666666666666666,2,0
wikimedia_puppet,standard_packages.pp,16,0.3050847457627119,6,10
wikimedia_puppet,git_daemon.pp,4,0.3333333333333333,4,0
wikimedia_puppet,irc_echo.pp,2,0.8,2,0
wikimedia_puppet,json.pp,4,0.5454545454545454,4,0
wikimedia_puppet,ttl.pp,5,0.375,5,0
wikimedia_puppet,builder.pp,11,0.36764705882352944,5,6
wikimedia_puppet,openstack_manager.pp,9,0.3333333333333333,5,4
wikimedia_puppet,queue_server.pp,5,0.3333333333333333,5,0
wikimedia_puppet,piwik.pp,5,0.25,5,0
wikimedia_puppet,secondary.pp,14,0.24096385542168675,8,6
wikimedia_puppet,testreduce.pp,1,1.0,1,0
wikimedia_puppet,relay.pp,3,0.7272727272727273,3,0
wikimedia_puppet,auth.pp,3,0.75,3,0
wikimedia_puppet,credentials.pp,2,0.8,2,0
wikimedia_puppet,parsoid-rt-client.pp,2,0.5,2,0
wikimedia_puppet,parsoid-rt-server.pp,2,0.5,2,0
wikimedia_puppet,labtest.pp,5,0.3333333333333333,5,0
wikimedia_puppet,rsync_ruthenium.pp,1,1.0,1,0
wikimedia_puppet,cronrunner.pp,8,0.2857142857142857,4,4
wikimedia_puppet,rsync.pp,6,0.5172413793103449,4,2
wikimedia_puppet,apt_repository.pp,3,0.6666666666666666,3,0
wikimedia_puppet,dhcp_server.pp,2,0.8333333333333334,2,0
wikimedia_puppet,preseed_server.pp,1,1.0,1,0
wikimedia_puppet,tftp_server.pp,4,0.7272727272727273,4,0
wikimedia_puppet,web_server.pp,5,0.35714285714285715,5,0
wikimedia_puppet,interface_tweaks.pp,6,0.36363636363636365,6,0
wikimedia_puppet,opsonly.pp,4,0.25,4,0
wikimedia_puppet,bigbrother.pp,3,0.6,3,0
wikimedia_puppet,alerts.pp,17,0.29411764705882354,6,11
wikimedia_puppet,manager.pp,8,0.21052631578947367,8,0
wikimedia_puppet,updatetools.pp,3,0.4,3,0
wikimedia_puppet,parsoid-vd-client.pp,1,1.0,1,0
wikimedia_puppet,parsoid-vd-server.pp,1,1.0,1,0
wikimedia_puppet,parsoid_rt_client.pp,3,0.5,3,0
wikimedia_puppet,parsoid_rt_server.pp,2,0.5,2,0
wikimedia_puppet,parsoid_vd_client.pp,1,1.0,1,0
wikimedia_puppet,parsoid_vd_server.pp,2,0.5,2,0
wikimedia_puppet,wikitechprivatesettings.pp,3,0.6,3,0
wikimedia_puppet,rsync_caesium.pp,1,1.0,1,0
wikimedia_puppet,huge.pp,2,0.7142857142857143,2,0
wikimedia_puppet,rest.pp,2,0.7142857142857143,2,0
wikimedia_puppet,admin_web_updater.pp,4,0.4,4,0
wikimedia_puppet,wikiqueryskip.pp,2,0.6,2,0
wikimedia_puppet,meta.pp,10,0.23529411764705882,7,3
wikimedia_puppet,namenode.pp,4,0.45,4,0
wikimedia_puppet,resourcemanager.pp,4,0.3333333333333333,4,0
wikimedia_puppet,standby.pp,7,0.40540540540540543,5,2
wikimedia_puppet,metastore.pp,5,0.4444444444444444,5,0
wikimedia_puppet,database.pp,16,0.23728813559322035,8,8
wikimedia_puppet,disks.pp,4,0.25,4,0
wikimedia_puppet,mwrepl.pp,2,0.5,2,0
wikimedia_puppet,yubiauth.pp,3,0.3333333333333333,3,0
wikimedia_puppet,math.pp,2,0.8,2,0
wikimedia_puppet,tex.pp,4,0.4,4,0
wikimedia_puppet,rt_client.pp,5,0.2857142857142857,5,0
wikimedia_puppet,rt_server.pp,3,0.5,3,0
wikimedia_puppet,vd_client.pp,4,0.5,4,0
wikimedia_puppet,vd_server.pp,4,0.3333333333333333,4,0
wikimedia_puppet,camus.pp,5,0.6111111111111112,4,1
wikimedia_puppet,drop.pp,2,0.8333333333333334,2,0
wikimedia_puppet,guard.pp,4,0.3333333333333333,4,0
wikimedia_puppet,yhsm-daemon.pp,1,1.0,1,0
wikimedia_puppet,yhsm_daemon.pp,3,0.5,3,0
wikimedia_puppet,no_nfs_client.pp,2,0.6666666666666666,2,0
wikimedia_puppet,availability_collector.pp,2,0.5,2,0
wikimedia_puppet,trebuchet_testing.pp,3,0.5,3,0
wikimedia_puppet,uploadservice.pp,2,0.5,2,0
wikimedia_puppet,stats_reporter.pp,3,0.5,3,0
wikimedia_puppet,xhgui.pp,8,0.29411764705882354,8,0
wikimedia_puppet,staging.pp,7,0.43478260869565216,4,3
wikimedia_puppet,k8s.pp,8,0.25,4,4
wikimedia_puppet,killer.pp,2,0.6666666666666666,2,0
wikimedia_puppet,main.pp,20,0.4606741573033708,5,15
wikimedia_puppet,mx.pp,6,0.38095238095238093,4,2
wikimedia_puppet,sender.pp,7,0.3,7,0
wikimedia_puppet,programdashboard.pp,1,1.0,1,0
wikimedia_puppet,traffic_shaping.pp,4,0.3333333333333333,4,0
wikimedia_puppet,cnames.pp,2,0.5,2,0
wikimedia_puppet,appserver.pp,6,0.3,6,0
wikimedia_puppet,canary_api.pp,2,0.5,2,0
wikimedia_puppet,canary_appserver.pp,3,0.3333333333333333,3,0
wikimedia_puppet,generic_monitoring.pp,1,1.0,1,0
wikimedia_puppet,scaler.pp,3,0.4,3,0
wikimedia_puppet,jenkins_access.pp,1,1.0,1,0
wikimedia_puppet,light.pp,1,1.0,1,0
wikimedia_puppet,localbrowser.pp,2,0.6666666666666666,2,0
wikimedia_puppet,yhsm_yubikey_ksm.pp,3,0.5,3,0
wikimedia_puppet,instances.pp,8,0.37209302325581395,5,3
wikimedia_puppet,ipsec_allow.pp,3,0.3333333333333333,3,0
wikimedia_puppet,2fa.pp,4,0.4,4,0
wikimedia_puppet,vagrant_lxc.pp,2,0.5,2,0
wikimedia_puppet,nginxlogs.pp,2,0.75,2,0
wikimedia_puppet,wikitech_dumps.pp,3,0.5,3,0
wikimedia_puppet,debug_proxy.pp,8,0.3,8,0
wikimedia_puppet,paws.pp,2,0.6666666666666666,2,0
wikimedia_puppet,expose_puppet_certs.pp,4,0.42857142857142855,4,0
wikimedia_puppet,envscripts.pp,3,0.4444444444444444,3,0
wikimedia_puppet,https.pp,5,0.4666666666666667,5,0
wikimedia_puppet,mylvmbackup.pp,3,0.6,3,0
wikimedia_puppet,backup_dest.pp,4,0.3076923076923077,4,0
wikimedia_puppet,readable.pp,1,1.0,1,0
wikimedia_puppet,site_instances.pp,3,0.5,3,0
wikimedia_puppet,engine.pp,7,0.32142857142857145,5,2
wikimedia_puppet,apt_preferences.pp,2,0.6,2,0
wikimedia_puppet,baseimages.pp,3,0.7692307692307693,3,0
wikimedia_puppet,changeprop.pp,7,0.35714285714285715,7,0
wikimedia_puppet,kubebuilder.pp,4,0.625,4,0
wikimedia_puppet,dumper.pp,5,0.5,2,3
wikimedia_puppet,git.pp,3,0.6,3,0
wikimedia_puppet,initramfs.pp,1,1.0,1,0
wikimedia_puppet,yhsm_aead_sync.pp,1,1.0,1,0
wikimedia_puppet,integrated.pp,2,0.6,2,0
wikimedia_puppet,deployment_dir.pp,2,0.5,2,0
wikimedia_puppet,phpunit.pp,2,0.5,2,0
wikimedia_puppet,stream.pp,2,0.5,2,0
wikimedia_puppet,system.pp,4,0.4166666666666667,4,0
wikimedia_puppet,npmtravis.pp,2,0.5,2,0
wikimedia_puppet,jmxtrans.pp,2,0.6666666666666666,2,0
wikimedia_puppet,carbon_cache_instance.pp,1,1.0,1,0
wikimedia_puppet,toollabs.pp,9,0.22727272727272727,5,4
wikimedia_puppet,package_builder.pp,5,0.5,5,0
wikimedia_puppet,monitor_services.pp,6,0.3,6,0
wikimedia_puppet,tails.pp,1,1.0,1,0
wikimedia_puppet,clean.pp,2,0.6666666666666666,2,0
wikimedia_puppet,xcache.pp,5,0.5833333333333334,5,0
wikimedia_puppet,nfsclient.pp,6,0.35135135135135137,5,1
wikimedia_puppet,upgradetest.pp,2,0.6666666666666666,2,0
wikimedia_puppet,nfs_mount.pp,7,0.5789473684210527,7,0
wikimedia_puppet,backup_keys.pp,3,0.5,3,0
wikimedia_puppet,interfaces.pp,7,0.2222222222222222,7,0
wikimedia_puppet,nfsd.pp,1,1.0,1,0
wikimedia_puppet,commons.pp,1,1.0,1,0
wikimedia_puppet,mirrors.pp,6,0.2857142857142857,6,0
wikimedia_puppet,hugewikis.pp,2,0.5,2,0
wikimedia_puppet,regularwikis.pp,2,0.5,2,0
wikimedia_puppet,producer.pp,2,0.5,2,0
wikimedia_puppet,centralserver.pp,9,0.30434782608695654,4,5
wikimedia_puppet,coordinator.pp,6,0.5641025641025641,4,2
wikimedia_puppet,historical.pp,3,0.6153846153846154,3,0
wikimedia_puppet,middlemanager.pp,4,0.5625,4,0
wikimedia_puppet,overlord.pp,3,0.6923076923076923,3,0
wikimedia_puppet,firejail.pp,2,0.8888888888888888,2,0
wikimedia_puppet,openldapset.pp,2,0.6666666666666666,2,0
wikimedia_puppet,constants.pp,25,0.17894736842105263,7,18
wikimedia_puppet,endowment.pp,3,0.4,3,0
wikimedia_puppet,netmapper_update_common.pp,1,1.0,1,0
wikimedia_puppet,wikimedia_vcl.pp,5,0.6,5,0
wikimedia_puppet,merlbot_proxy.pp,2,0.5,2,0
wikimedia_puppet,master_dir.pp,3,0.3333333333333333,3,0
wikimedia_puppet,postgresql_common.pp,2,0.6,2,0
wikimedia_puppet,sidekick.pp,3,0.3333333333333333,3,0
wikimedia_puppet,nagios_lib.pp,1,1.0,1,0
wikimedia_puppet,servicestats_lib.pp,1,1.0,1,0
wikimedia_puppet,instancersync.pp,2,0.6666666666666666,2,0
wikimedia_puppet,analytics_data.pp,2,0.5,2,0
wikimedia_puppet,varnishkafka.pp,2,0.5,2,0
wikimedia_puppet,views.pp,8,0.5,8,0
wikimedia_puppet,pybaltest.pp,6,0.3,6,0
wikimedia_puppet,ores_labs_web_node.pp,1,1.0,1,0
wikimedia_puppet,maintain_kubeusers.pp,5,0.3333333333333333,5,0
wikimedia_puppet,destination.pp,3,0.5,3,0
wikimedia_puppet,androidsdk.pp,2,0.6,2,0
wikimedia_puppet,wmde.pp,8,0.375,5,3
wikimedia_puppet,node_exporter.pp,11,0.36666666666666664,5,6
wikimedia_puppet,gitprivate.pp,3,0.7142857142857143,3,0
wikimedia_puppet,bootparam.pp,3,0.3333333333333333,3,0
wikimedia_puppet,web_test.pp,1,1.0,1,0
wikimedia_puppet,transition_cleanup.pp,1,1.0,1,0
wikimedia_puppet,conftool.pp,3,0.7142857142857143,3,0
wikimedia_puppet,cronjobs.pp,2,0.625,2,0
wikimedia_puppet,replica.pp,8,0.5135135135135135,4,4
wikimedia_puppet,wmf.pp,3,0.7142857142857143,3,0
wikimedia_puppet,cerium.pp,2,0.5,2,0
wikimedia_puppet,praseodymium.pp,2,0.5,2,0
wikimedia_puppet,logreceiver.pp,1,1.0,1,0
wikimedia_puppet,mgmt.pp,3,0.3333333333333333,3,0
wikimedia_puppet,sendlogs.pp,1,1.0,1,0
wikimedia_puppet,wmde_user.pp,1,1.0,1,0
wikimedia_puppet,mysqld_exporter.pp,4,0.5,4,0
wikimedia_puppet,bad_directory_owner.pp,2,0.5,2,0
wikimedia_puppet,contentxlation.pp,3,0.7,3,0
wikimedia_puppet,dns_floating_ip_updater.pp,6,0.2727272727272727,4,2
wikimedia_puppet,spiceproxy.pp,4,0.38461538461538464,4,0
wikimedia_puppet,pagecounts_ez.pp,3,0.7777777777777778,3,0
wikimedia_puppet,labsrootpass.pp,1,1.0,1,0
wikimedia_puppet,expose_metrics.pp,2,0.5,2,0
wikimedia_puppet,blackbox_exporter.pp,3,0.5,3,0
wikimedia_puppet,puppetdb.pp,10,0.32608695652173914,4,6
wikimedia_puppet,mysql_password.pp,5,0.25,5,0
wikimedia_puppet,nova_functions.pp,2,0.5,2,0
wikimedia_puppet,query_node_examples.pp,2,0.5,2,0
wikimedia_puppet,query_resource_examples.pp,2,0.5,2,0
wikimedia_puppet,umask_wikidev.pp,1,1.0,1,0
wikimedia_puppet,log4j.pp,2,0.5,2,0
wikimedia_puppet,dhcp.pp,2,0.625,2,0
wikimedia_puppet,build.pp,4,0.4,4,0
wikimedia_puppet,web_frontend.pp,5,0.5,5,0
wikimedia_puppet,puppetpanel.pp,5,0.42857142857142855,5,0
wikimedia_puppet,cirrus.pp,4,0.7777777777777778,4,0
wikimedia_puppet,relforge.pp,5,0.5333333333333333,5,0
wikimedia_puppet,twofa.pp,4,0.4,4,0
wikimedia_puppet,google_api_proxy.pp,3,0.5,3,0
wikimedia_puppet,yarn.pp,3,0.375,3,0
wikimedia_puppet,yamlcreds.pp,3,0.3333333333333333,3,0
wikimedia_puppet,pivot.pp,4,0.6923076923076923,4,0
wikimedia_puppet,bot.pp,1,1.0,1,0
wikimedia_puppet,orchestration.pp,2,0.6666666666666666,2,0
wikimedia_puppet,check_prometheus.pp,5,0.5,5,0
wikimedia_puppet,android.pp,3,0.5,3,0
wikimedia_puppet,standalone.pp,11,0.2608695652173913,5,6
wikimedia_puppet,site_hdfs.pp,3,0.3333333333333333,3,0
wikimedia_puppet,deploymentserver.pp,3,0.5,3,0
wikimedia_puppet,bootstrapvz.pp,2,0.5,2,0
wikimedia_puppet,querykiller.pp,3,0.6,3,0
wikimedia_puppet,twcs.pp,1,1.0,1,0
wikimedia_puppet,varnish_exporter.pp,3,0.5,3,0
wikimedia_puppet,kubernetes.pp,2,0.7142857142857143,2,0
wikimedia_puppet,networking.pp,2,0.6666666666666666,2,0
wikimedia_puppet,testns.pp,3,0.5,3,0
wikimedia_puppet,self.pp,3,0.6,3,0
wikimedia_puppet,cruncher.pp,11,0.41379310344827586,5,6
wikimedia_puppet,recommendation_api.pp,4,0.3333333333333333,4,0
wikimedia_puppet,drbd.pp,2,0.5,2,0
wikimedia_puppet,aphlict.pp,5,0.5,5,0
wikimedia_puppet,logical_volume.pp,3,0.3333333333333333,3,0
wikimedia_puppet,volume_group.pp,2,0.5,2,0
wikimedia_puppet,prometheus.pp,14,0.23333333333333334,7,7
wikimedia_puppet,bdsync.pp,5,0.3333333333333333,5,0
wikimedia_puppet,device_backup.pp,5,0.5,5,0
wikimedia_puppet,raid.pp,5,0.375,5,0
wikimedia_puppet,thinpool.pp,2,0.6666666666666666,2,0
wikimedia_puppet,testbed.pp,2,0.8333333333333334,2,0
wikimedia_puppet,slave_users.pp,2,0.6666666666666666,2,0
wikimedia_puppet,varnish_config.pp,1,1.0,1,0
wikimedia_puppet,varnish_2layer.pp,2,0.8333333333333334,2,0
wikimedia_puppet,drac_ilo.pp,1,1.0,1,0
wikimedia_puppet,doxygen.pp,1,1.0,1,0
wikimedia_puppet,jupyterhub.pp,6,0.45454545454545453,6,0
wikimedia_puppet,program.pp,3,0.3333333333333333,3,0
wikimedia_puppet,mysql_credentials.pp,2,0.5,2,0
wikimedia_puppet,mysql_access.pp,2,0.5,2,0
wikimedia_puppet,devserver.pp,3,0.5,3,0
wikimedia_puppet,runtime.pp,1,1.0,1,0
wikimedia_puppet,loopback.pp,2,0.75,2,0
wikimedia_puppet,instance_info_dumper.pp,5,0.42857142857142855,5,0
wikimedia_puppet,graphite_freshness.pp,1,1.0,1,0
wikimedia_puppet,tilerator_user.pp,1,1.0,1,0
wikimedia_puppet,eventstreams.pp,6,0.4666666666666667,6,0
wikimedia_puppet,memcached_exporter.pp,3,0.5,3,0
wikimedia_puppet,cluster_config.pp,4,0.25,4,0
wikimedia_puppet,conf_env.pp,1,1.0,1,0
wikimedia_puppet,postgresql.pp,1,1.0,1,0
wikimedia_puppet,pdfrender.pp,3,0.625,3,0
wikimedia_puppet,bonding.pp,2,0.5,2,0
wikimedia_puppet,trendingedits.pp,3,0.6666666666666666,3,0
wikimedia_puppet,check_private_data.pp,2,0.8,2,0
wikimedia_puppet,node_vhtcpd.pp,2,0.75,2,0
wikimedia_puppet,otrsbackups.pp,4,0.5714285714285714,4,0
wikimedia_puppet,apifeatureusage.pp,4,0.5,4,0
wikimedia_puppet,puppetreports.pp,2,0.5,2,0
wikimedia_puppet,http.pp,2,0.6,2,0
wikimedia_puppet,tftp.pp,3,0.45454545454545453,3,0
wikimedia_puppet,preseed.pp,3,0.5,3,0
wikimedia_puppet,zeromq.pp,5,0.2,5,0
wikimedia_puppet,clientlib.pp,7,0.42857142857142855,4,3
wikimedia_puppet,node_gdnsd.pp,2,0.5,2,0
wikimedia_puppet,generatecaptcha.pp,6,0.5,6,0
wikimedia_puppet,apache_exporter.pp,3,0.5,3,0
wikimedia_puppet,hhvm_exporter.pp,3,0.5,3,0
wikimedia_puppet,observerenv.pp,4,0.4444444444444444,4,0
wikimedia_puppet,maintain_dbusers.pp,6,0.4444444444444444,6,0
wikimedia_puppet,cni.pp,1,1.0,1,0
wikimedia_puppet,timesyncd.pp,4,0.45454545454545453,4,0
wikimedia_puppet,pageassessments.pp,1,1.0,1,0
wikimedia_puppet,dbstore.pp,7,0.375,7,0
wikimedia_puppet,dbstore2.pp,5,0.4444444444444444,5,0
wikimedia_puppet,htpasswd_file.pp,1,1.0,1,0
wikimedia_puppet,configcluster.pp,4,0.4444444444444444,4,0
wikimedia_puppet,precise_reminder.pp,4,0.4,4,0
wikimedia_puppet,import.pp,1,1.0,1,0
wikimedia_puppet,replication.pp,3,0.42857142857142855,3,0
wikimedia_puppet,aggregate_member.pp,1,1.0,1,0
wikimedia_puppet,modparams.pp,2,0.6666666666666666,2,0
wikimedia_puppet,certspotter.pp,2,0.5,2,0
wikimedia_puppet,class_config.pp,2,0.8,2,0
wikimedia_puppet,absolute_path.pp,1,1.0,1,0
wikimedia_puppet,absolutepath.pp,1,1.0,1,0
wikimedia_puppet,array.pp,1,1.0,1,0
wikimedia_puppet,bool.pp,1,1.0,1,0
wikimedia_puppet,ensure_resources.pp,1,1.0,1,0
wikimedia_puppet,float.pp,1,1.0,1,0
wikimedia_puppet,hash.pp,1,1.0,1,0
wikimedia_puppet,httpsurl.pp,1,1.0,1,0
wikimedia_puppet,httpurl.pp,1,1.0,1,0
wikimedia_puppet,integer.pp,1,1.0,1,0
wikimedia_puppet,ip_address.pp,1,1.0,1,0
wikimedia_puppet,ipv4.pp,1,1.0,1,0
wikimedia_puppet,ipv6.pp,1,1.0,1,0
wikimedia_puppet,numeric.pp,1,1.0,1,0
wikimedia_puppet,string.pp,1,1.0,1,0
wikimedia_puppet,unixpath.pp,1,1.0,1,0
wikimedia_puppet,windowspath.pp,1,1.0,1,0
wikimedia_puppet,re.pp,1,1.0,1,0
wikimedia_puppet,fullstack.pp,6,0.47058823529411764,6,0
wikimedia_puppet,nginx_bootstrap.pp,1,1.0,1,0
wikimedia_puppet,cache_warmup.pp,1,1.0,1,0
wikimedia_puppet,discovery_statefile.pp,1,1.0,1,0
wikimedia_puppet,configmaster.pp,3,0.5,3,0
wikimedia_puppet,saucelabs.pp,2,0.6666666666666666,2,0
wikimedia_puppet,sanitarium.pp,2,0.6666666666666666,2,0
wikimedia_puppet,sanitarium2.pp,3,0.6666666666666666,3,0
wikimedia_puppet,ns.pp,2,0.75,2,0
wikimedia_puppet,parsercache.pp,6,0.5454545454545454,6,0
wikimedia_puppet,core.pp,7,0.5416666666666666,3,4
wikimedia_puppet,data_check.pp,4,0.5,4,0
wikimedia_puppet,data_drop.pp,5,0.5,5,0
wikimedia_puppet,uploads.pp,2,0.5,2,0
wikimedia_puppet,slaves.pp,2,0.5,2,0
wikimedia_puppet,mysqld_safe.pp,1,1.0,1,0
wikimedia_puppet,packages_client.pp,1,1.0,1,0
wikimedia_puppet,keystonechecks.pp,3,0.3333333333333333,3,0
wikimedia_puppet,planet_server.pp,5,0.45454545454545453,5,0
wikimedia_puppet,snmp_exporter.pp,2,0.6,2,0
wikimedia_puppet,tor_relay.pp,2,0.8571428571428571,2,0
wikimedia_puppet,static_bugzilla.pp,3,0.5555555555555556,3,0
wikimedia_puppet,webserver_misc_static.pp,4,0.5454545454545454,4,0
wikimedia_puppet,requesttracker_server.pp,3,0.5,3,0
wikimedia_puppet,diffserver.pp,2,0.6666666666666666,2,0
wikimedia_puppet,project_namespace_map.pp,2,0.7142857142857143,2,0
wikimedia_puppet,sqoop_mediawiki.pp,6,0.2857142857142857,5,1
wikimedia_puppet,db_lag_stats.pp,2,0.6666666666666666,2,0
wikimedia_puppet,nrpe_instance.pp,2,0.6666666666666666,2,0
wikimedia_puppet,failoid.pp,2,0.6,2,0
wikimedia_puppet,multidc.pp,3,0.7142857142857143,3,0
wikimedia_puppet,multidc_instance.pp,1,1.0,1,0
wikimedia_puppet,grafana_alert.pp,3,0.3333333333333333,3,0
wikimedia_puppet,pdu_config.pp,2,0.5,2,0
wikimedia_puppet,labs_deprecated.pp,5,0.2857142857142857,5,0
wikimedia_puppet,scap3.pp,1,1.0,1,0
wikimedia_puppet,memkeys.pp,2,0.6666666666666666,2,0
wikimedia_puppet,switchdc.pp,2,0.75,2,0
wikimedia_puppet,offsite.pp,1,1.0,1,0
wikimedia_puppet,seen.pp,2,0.5,2,0
wikimedia_puppet,rdf.pp,2,0.8571428571428571,2,0
wikimedia_puppet,mediawiki_maintenance.pp,5,0.25,5,0
wikimedia_puppet,reading_web.pp,1,1.0,1,0
wikimedia_puppet,pybal_configuration.pp,3,0.3333333333333333,3,0
wikimedia_puppet,dev_cluster.pp,1,1.0,1,0
wikimedia_puppet,test_cluster.pp,2,0.5,2,0
wikimedia_puppet,alias.pp,1,1.0,1,0
wikimedia_puppet,yubiauth_server.pp,1,1.0,1,0
wikimedia_puppet,phabricator_server.pp,2,0.8333333333333334,2,0
wikimedia_puppet,node_puppet_agent.pp,2,0.5,2,0
wikimedia_puppet,curator.pp,2,0.75,2,0
wikimedia_puppet,errorpage.pp,4,0.5,4,0
wikimedia_puppet,xmldump.pp,2,0.75,2,0
wikimedia_puppet,whisper_cleanup.pp,1,1.0,1,0
wikimedia_puppet,development.pp,2,0.6666666666666666,2,0
wikimedia_puppet,beta_dashboards.pp,1,1.0,1,0
wikimedia_puppet,dashboards.pp,2,0.6666666666666666,2,0
wikimedia_puppet,cran_pkg.pp,1,1.0,1,0
wikimedia_puppet,git_pkg.pp,1,1.0,1,0
wikimedia_puppet,github_pkg.pp,1,1.0,1,0
wikimedia_puppet,jobqueue_slave.pp,2,0.6666666666666666,2,0
wikimedia_puppet,pybal.pp,8,0.2777777777777778,8,0
wikimedia_puppet,kernel_config.pp,4,0.375,4,0
wikimedia_puppet,tagged_interface.pp,1,1.0,1,0
wikimedia_puppet,single_instance.pp,2,0.6666666666666666,2,0
wikimedia_puppet,apps.pp,2,0.75,2,0
wikimedia_puppet,osm_master.pp,3,0.5555555555555556,3,0
wikimedia_puppet,osm_slave.pp,3,0.5,3,0
wikimedia_puppet,canary.pp,3,0.5,3,0
wikimedia_puppet,quickdatacopy.pp,2,0.8571428571428571,2,0
wikimedia_puppet,hourlyschedule.pp,1,1.0,1,0
wikimedia_puppet,stresstest.pp,2,0.6666666666666666,2,0
wikimedia_puppet,dbstore_multiinstance.pp,5,0.59375,3,2
wikimedia_puppet,diffscan.pp,1,1.0,1,0
wikimedia_puppet,sanitarium3.pp,2,0.5,2,0
wikimedia_puppet,labsenc.pp,1,1.0,1,0
wikimedia_puppet,labsencapi.pp,2,0.5,2,0
wikimedia_puppet,geowiki.pp,3,0.6666666666666666,3,0
wikimedia_puppet,cruncher_new.pp,1,1.0,1,0
wikimedia_puppet,private_new.pp,1,1.0,1,0
wikimedia_puppet,blacklist.pp,4,0.4,4,0
wikimedia_puppet,options.pp,1,1.0,1,0
wikimedia_puppet,kafka_daemon.pp,3,0.7142857142857143,3,0
wikimedia_puppet,control.pp,6,0.4057971014492754,6,0
wikimedia_puppet,unit.pp,1,1.0,1,0
wikimedia_puppet,mysqld_exporter_instance.pp,1,1.0,1,0
wikimedia_puppet,webperformance.pp,2,0.5,2,0
wikimedia_puppet,cran.pp,1,1.0,1,0
wikimedia_puppet,github.pp,1,1.0,1,0
wikimedia_puppet,cloudrepo.pp,5,0.6571428571428571,5,0
wikimedia_puppet,net.pp,4,0.625,3,1
wikimedia_puppet,virt.pp,3,0.7407407407407407,3,0
wikimedia_puppet,net_secondary.pp,1,1.0,1,0
wikimedia_puppet,sanitarium_multisource.pp,4,0.4,4,0
wikimedia_puppet,sanitarium_multiinstance.pp,4,0.7,4,0
wikimedia_puppet,rabbitmq.pp,5,0.34615384615384615,4,1
wikimedia_puppet,production_ng.pp,1,1.0,1,0
wikimedia_puppet,dump_global_block.pp,1,1.0,1,0
wikimedia_puppet,jmx_exporter_config.pp,3,0.5,3,0
wikimedia_puppet,jmx_exporter_instance.pp,3,0.6,3,0
wikimedia_puppet,dump_global_blocks.pp,2,0.875,2,0
wikimedia_puppet,cleanup.pp,4,0.4,4,0
wikimedia_puppet,browsersec.pp,3,0.5,3,0
wikimedia_puppet,image_sync.pp,2,0.6666666666666666,2,0
wikimedia_puppet,admin_scripts.pp,4,0.42857142857142855,4,0
wikimedia_puppet,dumpsdata.pp,2,0.8,2,0
wikimedia_puppet,logback_config.pp,1,1.0,1,0
wikimedia_puppet,jbod_device.pp,1,1.0,1,0
wikimedia_puppet,categoriesrdf.pp,2,0.75,2,0
wikimedia_puppet,jobrunner_tls.pp,1,1.0,1,0
wikimedia_puppet,cpjobqueue.pp,3,0.5,3,0
wikimedia_puppet,htmldumps.pp,2,0.6363636363636364,2,0
wikimedia_puppet,xmldumps.pp,2,0.6896551724137931,2,0
wikimedia_puppet,nfs_server.pp,1,1.0,1,0
wikimedia_puppet,rsync_server.pp,1,1.0,1,0
wikimedia_puppet,ferm_wmcs.pp,6,0.3076923076923077,6,0
wikimedia_puppet,xmldumps_active.pp,3,0.5833333333333334,3,0
wikimedia_puppet,xmldumps_fallback.pp,3,0.6,2,1
wikimedia_puppet,memfix.pp,1,1.0,1,0
wikimedia_puppet,rsyncer.pp,3,0.625,3,0
wikimedia_puppet,rsyncer_peer.pp,2,0.6153846153846154,2,0
wikimedia_puppet,public_server.pp,3,0.5555555555555556,3,0
wikimedia_puppet,fetcher.pp,4,0.5714285714285714,4,0
wikimedia_puppet,generation.pp,1,1.0,1,0
wikimedia_puppet,nginx_logrot.pp,1,1.0,1,0
wikimedia_puppet,deep_storage.pp,1,1.0,1,0
wikimedia_puppet,cloner.pp,1,1.0,1,0
wikimedia_puppet,backup_mydumper.pp,1,1.0,1,0
wikimedia_puppet,slowparse_logs.pp,2,0.8,2,0
wikimedia_puppet,downloadserver.pp,2,0.5,2,0
wikimedia_puppet,wikibase.pp,3,0.46153846153846156,3,0
wikimedia_puppet,filebackend.pp,1,1.0,1,0
wikimedia_puppet,cron_restart.pp,3,0.6,3,0
wikimedia_puppet,traffic_pool.pp,1,1.0,1,0
wikimedia_puppet,instance_pair.pp,5,0.3333333333333333,5,0
wikimedia_puppet,vectortiles_master.pp,2,0.6666666666666666,2,0
wikimedia_puppet,host_check.pp,1,1.0,1,0
wikimedia_puppet,pdns_control.pp,4,0.4,4,0
wikimedia_puppet,rec_control.pp,3,0.5,3,0
wikimedia_puppet,net_standby.pp,3,0.42857142857142855,3,0
wikimedia_puppet,services_primary.pp,7,0.2222222222222222,7,0
wikimedia_puppet,services_secondary.pp,4,0.25,4,0
wikimedia_puppet,eventlogging_refine_test.pp,1,1.0,1,0
wikimedia_puppet,cleartables_sync.pp,2,0.5714285714285714,2,0
wikimedia_puppet,meddo.pp,1,1.0,1,0
wikimedia_puppet,pipeline.pp,2,0.6666666666666666,2,0
wikimedia_puppet,multiinstance.pp,5,0.47058823529411764,5,0
wikimedia_puppet,core_multiinstance.pp,2,0.5,2,0
wikimedia_puppet,gitcache.pp,1,1.0,1,0
wikimedia_puppet,jmx_exporter.pp,3,0.5,3,0
wikimedia_puppet,exec.pp,1,1.0,1,0
wikimedia_puppet,sources_config.pp,2,0.6666666666666666,2,0
wikimedia_puppet,tmpfile.pp,1,1.0,1,0
wikimedia_puppet,rlang.pp,1,1.0,1,0
wikimedia_puppet,replica_config.pp,1,1.0,1,0
wikimedia_puppet,bayesian_statistics.pp,2,0.6666666666666666,2,0
wikimedia_puppet,deep_learning.pp,2,0.75,2,0
wikimedia_puppet,forecasting.pp,2,0.5,2,0
wikimedia_puppet,machine_learning.pp,2,0.75,2,0
wikimedia_puppet,bioc.pp,1,1.0,1,0
wikimedia_puppet,allstar_cruncher.pp,3,0.3333333333333333,3,0
wikimedia_puppet,bayes.pp,3,0.3333333333333333,3,0
wikimedia_puppet,deep_learner.pp,3,0.3333333333333333,3,0
wikimedia_puppet,forecaster.pp,3,0.5,3,0
wikimedia_puppet,learner.pp,4,0.25,4,0
wikimedia_puppet,noflow.pp,2,0.8333333333333334,2,0
wikimedia_puppet,enc.pp,2,0.5,2,0
wikimedia_puppet,encapi.pp,4,0.6923076923076923,4,0
wikimedia_puppet,json_refine.pp,3,0.7857142857142857,3,0
wikimedia_puppet,json_refine_job.pp,1,1.0,1,0
wikimedia_puppet,dumper_misc.pp,2,0.8,2,0
wikimedia_puppet,shipyard.pp,3,0.5,3,0
wikimedia_puppet,xml_cleanup.pp,2,0.5,2,0
wikimedia_puppet,fallback.pp,2,0.7333333333333333,2,0
wikimedia_puppet,nfsmount.pp,2,0.6,2,0
wikimedia_puppet,redis_exporter.pp,1,1.0,1,0
wikimedia_puppet,puppet4.pp,1,1.0,1,0
wikimedia_puppet,wdcm.pp,1,1.0,1,0
wikimedia_puppet,publisher.pp,2,0.6666666666666666,2,0
wikimedia_puppet,libraryupgrader.pp,1,1.0,1,0
wikimedia_puppet,redis_exporter_config.pp,2,0.5,2,0
wikimedia_puppet,kubeconfig.pp,1,1.0,1,0
wikimedia_puppet,webserver_misc_apps.pp,3,0.4,3,0
wikimedia_puppet,netbox.pp,7,0.3793103448275862,4,3
wikimedia_puppet,druid_exporter.pp,2,0.6666666666666666,2,0
wikimedia_puppet,proxysql.pp,2,0.6,2,0
wikimedia_puppet,anycast.pp,2,0.5,2,0
wikimedia_puppet,explorer.pp,4,0.42857142857142855,4,0
wikimedia_puppet,dumpstatusfiles.pp,2,0.5,2,0
wikimedia_puppet,dumpstatusfiles_sync.pp,2,0.8,2,0
wikimedia_puppet,anycast_monitoring.pp,1,1.0,1,0
wikimedia_puppet,openldap_exporter.pp,1,1.0,1,0
wikimedia_puppet,datanode.pp,3,0.5,3,0
wikimedia_puppet,nodemanager.pp,3,0.5,3,0
wikimedia_puppet,exported_nagios_host.pp,2,0.6666666666666666,2,0
wikimedia_puppet,exported_nagios_service.pp,2,0.6666666666666666,2,0
wikimedia_puppet,dumper_shared.pp,2,0.6666666666666666,2,0
wikimedia_puppet,miscdumps.pp,2,0.6666666666666666,2,0
wikimedia_puppet,miscdatasets.pp,1,1.0,1,0
wikimedia_puppet,cleanup_miscdatasets.pp,2,0.6,2,0
wikimedia_puppet,dmarc.pp,1,1.0,1,0
wikimedia_puppet,history.pp,3,0.3333333333333333,3,0
wikimedia_puppet,etherpad_exporter.pp,2,0.6666666666666666,2,0
wikimedia_puppet,rawdogplugin.pp,2,0.5,2,0
wikimedia_puppet,superset.pp,1,1.0,1,0
wikimedia_puppet,wmf_root_client.pp,3,0.7142857142857143,3,0
wikimedia_puppet,ircd_exporter.pp,1,1.0,1,0
wikimedia_puppet,pdns_rec_exporter.pp,2,0.5,2,0
wikimedia_puppet,elasticsearch_exporter.pp,1,1.0,1,0
wikimedia_puppet,dba.pp,3,0.3333333333333333,3,0
wikimedia_puppet,postgres_exporter.pp,2,0.6666666666666666,2,0
wikimedia_puppet,jumbo.pp,3,0.5,3,0
wikimedia_puppet,rabbitmq_exporter.pp,4,0.4,4,0
wikimedia_puppet,wdqs_updater_exporter.pp,2,0.5,2,0
wikimedia_puppet,sanitization.pp,3,0.6,3,0
wikimedia_puppet,server_dirs.pp,1,1.0,1,0
wikimedia_puppet,nutcracker_exporter.pp,2,0.5,2,0
wikimedia_puppet,replicas.pp,2,0.6666666666666666,2,0
wikimedia_puppet,blazegraph_exporter.pp,1,1.0,1,0
wikimedia_puppet,dumpsuser.pp,2,0.5,2,0
wikimedia_puppet,pdns_exporter.pp,1,1.0,1,0
wikimedia_puppet,pdns_rec_exporter_wmcs.pp,3,0.3333333333333333,3,0
wikimedia_puppet,xmldumps_common.pp,3,0.3333333333333333,3,0
wikimedia_puppet,audit.pp,5,0.25,5,0
wikimedia_puppet,thumbor.pp,3,0.6666666666666666,3,0
wikimedia_puppet,recursor.pp,1,1.0,1,0
wikimedia_puppet,pop.pp,2,0.5,2,0
wikimedia_puppet,alerting_host.pp,4,0.5,4,0
wikimedia_puppet,ensure.pp,1,1.0,1,0
wikimedia_puppet,sourceurl.pp,1,1.0,1,0
wikimedia_puppet,httpd.pp,2,0.6666666666666666,2,0
wikimedia_puppet,research.pp,1,1.0,1,0
wikimedia_puppet,labs_localdisk.pp,1,1.0,1,0
wikimedia_puppet,datamount.pp,2,0.5,2,0
wikimedia_puppet,beta_testbed.pp,1,1.0,1,0
wikimedia_puppet,readinglists.pp,2,0.5,2,0
wikimedia_puppet,paws_internal.pp,3,0.3333333333333333,3,0
wikimedia_puppet,netmon.pp,2,0.6666666666666666,2,0
wikimedia_puppet,apt_pin.pp,2,0.5,2,0
wikimedia_puppet,ferm_restart_handler.pp,1,1.0,1,0
wikimedia_puppet,ferm_handlers.pp,1,1.0,1,0
wikimedia_puppet,streams_check.pp,3,0.5714285714285714,3,0
wikimedia_puppet,netinsights.pp,2,0.5,2,0
wikimedia_puppet,temporary_storage.pp,2,0.5,2,0
wikimedia_puppet,security.pp,1,1.0,1,0
wikimedia_puppet,shiny_server.pp,1,1.0,1,0
wikimedia_puppet,source_deploy.pp,2,0.5882352941176471,2,0
wikimedia_puppet,dashboard_source_deploy.pp,2,0.5833333333333334,2,0
wikimedia_puppet,labweb.pp,3,0.5882352941176471,3,0
wikimedia_puppet,web_interfaces.pp,1,1.0,1,0
wikimedia_puppet,log_fixes.pp,1,1.0,1,0
wikimedia_puppet,nova_network.pp,4,0.4,4,0
wikimedia_puppet,icu57.pp,1,1.0,1,0
wikimedia_puppet,bootstrap.pp,3,0.42857142857142855,3,0
wikimedia_puppet,bacula.pp,1,1.0,1,0
wikimedia_puppet,mydumper.pp,2,0.625,2,0
wikimedia_puppet,dbstore_multiinstance_backups.pp,1,1.0,1,0
wikimedia_puppet,codfw.pp,1,1.0,1,0
wikimedia_puppet,eqiad.pp,1,1.0,1,0
wikimedia_puppet,auto_restarts.pp,1,1.0,1,0
wikimedia_puppet,service_auto_restart.pp,1,1.0,1,0
wikimedia_puppet,burrow_exporter.pp,3,0.6666666666666666,3,0
wikimedia_puppet,l3_agent.pp,4,0.5,3,1
wikimedia_puppet,core_test.pp,3,0.6,3,0
wikimedia_puppet,apt_pinning.pp,4,0.7857142857142857,4,0
wikimedia_puppet,input.pp,1,1.0,1,0
wikimedia_puppet,output.pp,3,0.5,3,0
wikimedia_puppet,wmf_elasticsearch_exporter.pp,3,0.7142857142857143,3,0
wikimedia_puppet,design.pp,2,0.6666666666666666,2,0
wikimedia_puppet,backends.pp,1,1.0,1,0
wikimedia_puppet,projects_and_users.pp,1,1.0,1,0
wikimedia_puppet,spark2.pp,1,1.0,1,0
wikimedia_puppet,wikitech_static_sync.pp,1,1.0,1,0
wikimedia_puppet,rsync_config.pp,2,0.6,2,0
wikimedia_puppet,ipport.pp,1,1.0,1,0
wikimedia_puppet,etcd_mw_config.pp,4,0.4,4,0
wikimedia_puppet,wdqs_internal.pp,1,1.0,1,0
wikimedia_puppet,unit_type.pp,1,1.0,1,0
wikimedia_puppet,refine.pp,3,0.8333333333333334,3,0
wikimedia_puppet,refine_job.pp,1,1.0,1,0
wikimedia_puppet,rabbit.pp,1,1.0,1,0
wikimedia_puppet,dhcp_agent.pp,4,0.375,4,0
wikimedia_puppet,metadata_agent.pp,4,0.4666666666666667,4,0
wikimedia_puppet,ml2.pp,2,0.6923076923076923,2,0
wikimedia_puppet,ferm_misc.pp,2,0.6666666666666666,2,0
wikimedia_puppet,kmod.pp,2,0.5,2,0
wikimedia_puppet,labtestwikitech.pp,3,0.5,3,0
wikimedia_puppet,postgres_database.pp,1,1.0,1,0
wikimedia_puppet,legacy_local_database.pp,1,1.0,1,0
wikimedia_puppet,linuxbridge_agent.pp,4,0.6,4,0
wikimedia_puppet,puppetboard.pp,3,0.5,3,0
wikimedia_puppet,replication_key.pp,1,1.0,1,0
wikimedia_puppet,php7.pp,3,0.3333333333333333,3,0
wikimedia_puppet,purge_expired_userrights.pp,1,1.0,1,0
wikimedia_puppet,v3.pp,1,1.0,1,0
wikimedia_puppet,configcluster_stretch.pp,3,0.6666666666666666,3,0
wikimedia_puppet,ca_server.pp,1,1.0,1,0
wikimedia_puppet,pipelinebuilder.pp,2,0.5,2,0
wikimedia_puppet,check_consumer_lag.pp,1,1.0,1,0
wikimedia_puppet,chrony.pp,1,1.0,1,0
wikimedia_puppet,l3_agent_hacks.pp,1,1.0,1,0
wikimedia_puppet,bridge.pp,2,0.6,2,0
wikimedia_puppet,initsitestats.pp,2,0.6666666666666666,2,0
wikimedia_puppet,stat_dumps.pp,1,1.0,1,0
wikimedia_puppet,populate_admin.pp,2,0.6666666666666666,2,0
wikimedia_puppet,trusted_proxies.pp,1,1.0,1,0
wikimedia_puppet,mcrouter_wancache.pp,1,1.0,1,0
wikimedia_puppet,backups_and_dbstore_multiinstance.pp,1,1.0,1,0
wikimedia_puppet,ping_offload.pp,1,1.0,1,0
wikimedia_puppet,analytics_a.pp,3,0.6,3,0
wikimedia_puppet,analytics_b.pp,3,0.6,3,0
wikimedia_puppet,jessie_mitaka_pinning.pp,2,0.5,2,0
wikimedia_puppet,disable_atop.pp,2,0.5,2,0
wikimedia_puppet,journalnode.pp,3,0.3333333333333333,3,0
wikimedia_puppet,clientrepo.pp,2,0.75,2,0
wikimedia_puppet,jessie_mitaka_client_pinning.pp,2,0.5,2,0
wikimedia_puppet,phab.pp,2,0.5,2,0
wikimedia_puppet,mcrouter_exporter.pp,3,0.5,3,0
wikimedia_puppet,crontester.pp,1,1.0,1,0
wikimedia_puppet,http_availability.pp,1,1.0,1,0
wikimedia_puppet,data_purge.pp,7,0.3181818181818182,4,3
wikimedia_puppet,turnilo.pp,3,0.7142857142857143,3,0
wikimedia_puppet,proton.pp,3,0.42857142857142855,3,0
wikimedia_puppet,internal.pp,1,1.0,1,0
wikimedia_puppet,profiling_tools.pp,4,0.5,4,0
wikimedia_puppet,mono_external_repo.pp,1,1.0,1,0
wikimedia_puppet,ferm_wmcs_on_port_3325.pp,1,1.0,1,0
wikimedia_puppet,jobswatcher.pp,1,1.0,1,0
wikimedia_puppet,mcrouter_pools.pp,1,1.0,1,0
wikimedia_puppet,dumper_misc_crons_only.pp,1,1.0,1,0
wikimedia_puppet,mcrouter_ca.pp,1,1.0,1,0
wikimedia_puppet,processors_and_site.pp,3,0.5,3,0
wikimedia_puppet,physical_volume.pp,1,1.0,1,0
wikimedia_puppet,node_intel_microcode.pp,1,1.0,1,0
wikimedia_puppet,timer.pp,3,0.3333333333333333,3,0
wikimedia_puppet,interval.pp,1,1.0,1,0
wikimedia_puppet,start.pp,1,1.0,1,0
wikimedia_puppet,traffic.pp,1,1.0,1,0
wikimedia_puppet,kubernetes_config.pp,1,1.0,1,0
wikimedia_puppet,jvm.pp,2,0.5,2,0
wikimedia_puppet,gitconfig.pp,1,1.0,1,0
wikimedia_puppet,web_testing.pp,1,1.0,1,0
wikimedia_puppet,systemconfig.pp,1,1.0,1,0
wikimedia_puppet,updatenetboot.pp,1,1.0,1,0
wikimedia_puppet,timechecker.pp,1,1.0,1,0
wikimedia_puppet,statsender.pp,1,1.0,1,0
wikimedia_puppet,python_exec_stretch.pp,1,1.0,1,0
wikimedia_puppet,hot_threads_cluster.pp,1,1.0,1,0
wikimedia_puppet,route.pp,2,0.5,2,0
wikimedia_puppet,resource_config.pp,1,1.0,1,0
wikimedia_puppet,regen.pp,2,0.8333333333333334,2,0
wikimedia_puppet,monitor_readonly.pp,1,1.0,1,0
wikimedia_puppet,rewrites.pp,1,1.0,1,0
wikimedia_puppet,coal_web.pp,1,1.0,1,0
wikimedia_puppet,processors.pp,1,1.0,1,0
wikimedia_puppet,logstash_exporter.pp,1,1.0,1,0
wikimedia_puppet,mapping_rule.pp,1,1.0,1,0
wikimedia_puppet,mjolnir.pp,1,1.0,1,0
wikimedia_puppet,kafka_bulk_daemon.pp,1,1.0,1,0
wikimedia_puppet,kafka_msearch_daemon.pp,1,1.0,1,0
wikimedia_puppet,sitemaps.pp,3,0.3333333333333333,3,0
wikimedia_puppet,arclamp.pp,1,1.0,1,0
wikimedia_puppet,lua_script.pp,1,1.0,1,0
wikimedia_puppet,datetime.pp,2,0.75,2,0
wikimedia_puppet,storage_element.pp,1,1.0,1,0
wikimedia_puppet,caching_rule.pp,1,1.0,1,0
wikimedia_puppet,default_extensions.pp,1,1.0,1,0
wikimedia_puppet,sapi.pp,1,1.0,1,0
wikimedia_puppet,trafficserver_exporter.pp,1,1.0,1,0
wikimedia_puppet,useripport.pp,1,1.0,1,0
wikimedia_puppet,yarn_proxy.pp,2,0.6666666666666666,2,0
wikimedia_puppet,stock_heartbeat.pp,1,1.0,1,0
wikimedia_puppet,traffic_drop.pp,1,1.0,1,0
wikimedia_puppet,spicerack.pp,2,0.6666666666666666,2,0
wikimedia_puppet,systemd_timer.pp,2,0.7142857142857143,2,0
wikimedia_puppet,state.pp,1,1.0,1,0
wikimedia_puppet,orespoolcounter.pp,1,1.0,1,0
wikimedia_puppet,dockervolume.pp,1,1.0,1,0
wikimedia_puppet,mibs.pp,1,1.0,1,0
wikimedia_puppet,haproxy_exporter.pp,1,1.0,1,0
wikimedia_puppet,spark_job.pp,1,1.0,1,0
wikimedia_puppet,instanceparams.pp,1,1.0,1,0
wikimedia_puppet,fpm.pp,1,1.0,1,0
wikimedia_puppet,monitor_backup.pp,1,1.0,1,0
wikimedia_puppet,tendril_and_zarcillo.pp,1,1.0,1,0
wikimedia_puppet,toolforge.pp,1,1.0,1,0
wikimedia_puppet,openstack_exporter.pp,1,1.0,1,0
wikimedia_puppet,probabilistic_programming.pp,1,1.0,1,0
wikimedia_puppet,kill_long_running_queries.pp,2,0.75,2,0
wikimedia_puppet,wikireplica.pp,1,1.0,1,0
wikimedia_puppet,wikireplica_analytics.pp,1,1.0,1,0
wikimedia_puppet,wikireplica_web.pp,1,1.0,1,0
wikimedia_puppet,upload_rewrite.pp,1,1.0,1,0
wikimedia_puppet,selector.pp,1,1.0,1,0
wikimedia_puppet,autodeploy.pp,2,0.875,2,0
wikimedia_puppet,backendtiming.pp,2,0.5,2,0
wikimedia_puppet,python_dev_stretch.pp,1,1.0,1,0
wikimedia_puppet,statsd_exporter.pp,1,1.0,1,0
wikimedia_puppet,cert.pp,1,1.0,1,0
wikimedia_puppet,certcentral.pp,1,1.0,1,0
wikimedia_puppet,druid_deep_storage.pp,1,1.0,1,0
wikimedia_puppet,smarthost.pp,1,1.0,1,0
wikimedia_puppet,wmcs.pp,1,1.0,1,0
wikimedia_puppet,certcentral_target.pp,2,0.5,2,0
wikimedia_puppet,deploymode.pp,1,1.0,1,0
wikimedia_puppet,druid_load.pp,1,1.0,1,0
wikimedia_puppet,eventlogging_to_druid_job.pp,2,0.5,2,0
wikimedia_translatewiki,init.pp,8,0.49444444444444446,4,4
wikimedia_translatewiki,site.pp,5,0.6122448979591837,3,2
wikimedia_translatewiki,mwelasticsearch.pp,6,0.4444444444444444,6,0
wikimedia_translatewiki,mediawiki.pp,2,0.6666666666666666,2,0
wikimedia_translatewiki,vcs.pp,2,0.6666666666666666,2,0
wikimedia_translatewiki,es.pp,3,0.5714285714285714,3,0
wikimedia_translatewiki,web1.pp,3,0.625,3,0
wikimedia_translatewiki,sites.pp,2,0.8333333333333334,2,0
wikimedia_translatewiki,ssl.pp,3,0.7142857142857143,3,0
